date,actual_deaths,total_deaths,predicted_deaths_mean,predicted_deaths_lower,predicted_deaths_upper,predicted_total_deaths_mean,predicted_total_deaths_lower,predicted_total_deaths_upper,predicted_new_infected_mean,predicted_new_infected_lower,predicted_new_infected_upper,predicted_current_infected_mean,predicted_current_infected_lower,predicted_current_infected_upper,predicted_total_infected_mean,predicted_total_infected_lower,predicted_total_infected_upper,r_values_mean,r_values_lower,r_values_upper
2020-02-05,0,0,,,,,,,125,64,177,125,64,177,125,64,177,2.25191135946,2.1,2.4
2020-02-06,0,0,,,,,,,125,64,177,250,128,354,250,128,354,2.25190177789,2.09998968769,2.39999963676
2020-02-07,0,0,,,,,,,125,64,177,375,191,531,375,192,531,2.25189853532,2.09998619619,2.39999944708
2020-02-08,0,0,,,,,,,125,64,177,500,256,708,500,256,708,2.25189418261,2.09998152838,2.39999916915
2020-02-09,0,0,,,,,,,289,162,404,789,433,1098,789,418,1112,2.2518883346,2.09997527417,2.39999874972
2020-02-10,0,0,,,,,,,289,162,404,1079,600,1497,1078,580,1516,2.25188047046,2.09996691502,2.39999811554
2020-02-11,0,0,,,,,,,289,162,404,1368,765,1898,1367,742,1920,2.25186988508,2.09995604025,2.39999714146
2020-02-12,0,0,,,,,,,289,162,404,1657,930,2300,1656,904,2324,2.25185562272,2.09994126917,2.39999566336
2020-02-13,0,0,,,,,,,465,278,649,2122,1226,2927,2121,1182,2973,2.25183638629,2.09992130453,2.39999342018
2020-02-14,0,0,,,,,,,672,409,939,2795,1641,3859,2793,1591,3912,2.25178141569,2.0998619703,2.39996479104
2020-02-15,0,0,,,,,,,1204,748,1630,3999,2443,5449,3997,2339,5542,2.25174268333,2.09982155993,2.39995722106
2020-02-16,0,0,,,,,,,2401,1468,3101,6400,4039,8487,6398,3807,8643,2.25168339738,2.09976103852,2.39993917117
2020-02-17,0,0,,,,,,,3860,2489,4914,10259,6660,13307,10258,6296,13557,2.25160729014,2.09968406278,2.39991757105
2020-02-18,0,0,,,,,,,4277,2804,5449,14537,9505,18728,14535,9100,19006,2.25150735101,2.0995840525,2.39988764574
2020-02-19,0,0,,,,,,,5041,3372,6403,19578,12941,25089,19576,12472,25409,2.25137433005,2.09945276376,2.39984592047
2020-02-20,0,0,,,,,,,5180,3479,6593,24633,16368,31496,24756,15951,32002,2.25119487385,2.09927886408,2.3997852714
2020-02-21,0,0,,,,,,,5711,3896,7251,30219,20226,38551,30467,19847,39253,2.25095118135,2.09904726894,2.39969555882
2020-02-22,0,0,,,,,,,6784,4703,8613,36878,24912,46948,37251,24550,47866,2.25062274392,2.09874102715,2.39956517571
2020-02-23,0,0,,,,,,,8122,5719,10281,44875,30661,56976,45373,30269,58147,2.25018008348,2.09833676715,2.39937508295
2020-02-24,0,0,,,,,,,10309,7251,13119,54895,37830,69633,55682,37520,71266,2.24958106617,2.09780181593,2.39910405031
2020-02-25,0,0,,,,,,,16171,10841,20542,70777,48685,89655,71853,48361,91808,2.24876775497,2.09709264344,2.39873772745
2020-02-26,0,0,,,,,,,19469,13309,24784,89956,61876,114001,91322,61670,116592,2.24766035068,2.09615118867,2.39821184316
2020-02-27,0,0,,,,,,,21228,14416,27231,110895,76144,140814,112550,76086,143823,2.24615071549,2.09491329342,2.39745449183
2020-02-28,0,0,,,,,,,25822,17340,33450,136252,93207,173605,138372,93426,177273,2.24409013815,2.09325631336,2.39635170196
2020-02-29,1,1,,,,,,,31545,20636,41523,167124,113443,214144,169917,114062,218796,2.24127362552,2.09105760796,2.39475613613
2020-03-01,0,1,,,,,,,40921,26214,54456,206841,138974,266859,210838,140276,273252,2.23741996239,2.08814100338,2.3924688305
2020-03-02,5,6,,,,,,,50804,32230,68078,255244,169847,331697,261642,172506,341330,2.23214558532,2.08427507358,2.38916673719
2020-03-03,1,7,,,,,,,62932,39736,84300,314316,207186,410967,324574,212242,425630,2.22493162724,2.07915141292,2.38433612978
2020-03-04,4,11,,,,,,,77061,48094,104034,387101,252564,509408,401635,260336,529664,2.21508314184,2.07239580166,2.37732890067
2020-03-05,1,12,,,,,,,96070,59567,129921,478129,308845,632777,497705,319903,659585,2.2016836268,2.06302308469,2.36834627441
2020-03-06,2,14,,,,,,,117210,72047,159172,590159,377495,785184,614915,391950,818757,2.18355308265,2.04745582174,2.35701476977
2020-03-07,3,17,,,,,,,140801,86947,192610,725248,460574,970331,755716,478897,1011367,2.15922585566,2.0259238038,2.33829827123
2020-03-08,4,21,,,,,,,166185,104729,227997,884650,560548,1189565,921901,583626,1239364,2.12697775936,1.98524863103,2.31195953256
2020-03-09,1,22,,,,,,,192568,125573,262174,1069095,680259,1441445,1114469,709199,1501538,2.08494571323,1.92533992896,2.2756860361
2020-03-10,6,28,,,,,,,219002,147677,296381,1277788,820429,1724758,1333471,856876,1797919,2.03138700571,1.85994842534,2.23953325281
2020-03-11,5,33,,,,,,,242121,167756,322910,1503738,977316,2027112,1575592,1024632,2120829,1.96509537784,1.77773289017,2.19556702894
2020-03-12,10,43,,,,,,,260864,182473,342027,1745133,1146367,2344405,1836456,1207105,2462856,1.8859069838,1.67687178378,2.14223072055
2020-03-13,9,52,,,,,,,275447,193213,363278,1999352,1325072,2680444,2111903,1400318,2826134,1.79511548292,1.57070951465,2.09257018629
2020-03-14,6,58,,,,,,,285795,201683,378560,2259326,1509370,3025501,2397698,1602001,3204694,1.69556941382,1.45000851462,2.04189462164
2020-03-15,12,70,,,,,,,293141,208503,392247,2520922,1697333,3376108,2690839,1810504,3596941,1.59133934616,1.32835536509,1.97618588082
2020-03-16,27,97,,,,,,,297696,214255,403799,2777697,1885633,3725324,2988535,2024759,4000740,1.48705819887,1.21888458491,1.88979472326
2020-03-17,35,132,,,,,,,300125,218864,406019,3027018,2072711,4063138,3288660,2243623,4406759,1.38717919388,1.12780993098,1.78330023876
2020-03-18,59,191,,,,,,,301101,222691,404688,3265187,2256295,4383343,3589761,2466314,4811447,1.29537590861,1.05685707986,1.66735459521
2020-03-19,77,268,,,,,,,301032,225710,401469,3489158,2434728,4680512,3890793,2692024,5212916,1.21419096758,1.00322948393,1.54450064446
2020-03-20,99,367,,,,,,,300319,227914,398528,3693407,2604075,4948680,4191112,2919938,5611444,1.1449299329,0.966410800433,1.43023761397
2020-03-21,95,462,,,,,,,299038,229655,393753,3875235,2762771,5182646,4490150,3149593,6005197,1.08775062226,0.940650801829,1.33350529011
2020-03-22,148,610,,,,,,,297263,230814,389037,4031698,2907724,5378349,4787413,3380407,6394234,1.04189556373,0.923363876016,1.25128241659
2020-03-23,187,797,,,,,,,295121,231226,381980,4160633,3035264,5531480,5082534,3611633,6776214,1.0060090458,0.909927194406,1.17535941089
2020-03-24,242,1039,,,,,,,292654,230544,377277,4260719,3141131,5645743,5375188,3842177,7153491,0.978463148275,0.89200797943,1.11222264387
2020-03-25,316,1355,,,,,,,289907,230140,370218,4331624,3224483,5718667,5665095,4072317,7523709,0.957621702427,0.877977484009,1.06168113121
2020-03-26,422,1777,,,,,,,286883,229383,363794,4376386,3286822,5758440,5951978,4301700,7887503,0.942007331808,0.867924905906,1.0245530946
2020-03-27,561,2338,,,,,,,283574,227337,357525,4399096,3332040,5772720,6235552,4529037,8245028,0.930377404207,0.859360840773,0.998818758832
2020-03-28,654,2992,,,,,,,279993,224478,351364,4403642,3363271,5759829,6515545,4753515,8596392,0.921736140094,0.853050688839,0.980503413253
2020-03-29,634,3626,,,,,,,276179,221342,345856,4394027,3382527,5726568,6791724,4974857,8942248,0.915311720201,0.848996686719,0.969479903997
2020-03-30,834,4460,,,,,,,272090,218810,339488,4372976,3392141,5673681,7063814,5193667,9281736,0.910519458482,0.845513404426,0.96185502094
2020-03-31,1255,5715,,,,,,,267777,214788,332868,4343056,3391616,5603287,7331591,5408455,9614604,0.906923307221,0.843436980742,0.956534549403
2020-04-01,1268,6983,,,,,,,263260,210741,326225,4306192,3382275,5524289,7594851,5619196,9940829,0.904201488126,0.842050019613,0.952310605837
2020-04-02,1613,8596,,,,,,,258569,206311,319793,4263659,3364574,5440284,7853420,5825507,10260622,0.902118198931,0.840811495914,0.948998018191
2020-04-03,1337,9933,,,,,,,253731,201827,313534,4216358,3339484,5353364,8107151,6027334,10574156,0.900501405868,0.839753794625,0.94648449804
2020-04-04,1327,11260,,,,,,,248774,197400,307463,4164814,3307918,5263431,8355925,6224734,10881619,0.899225926279,0.838998247263,0.944444115826
2020-04-05,1502,12762,,,,,,,243733,193118,301196,4109509,3270568,5171967,8599658,6417852,11182815,0.898200788315,0.838317144673,0.942815157249
2020-04-06,1739,14501,,,,,,,238643,188837,294836,4050889,3227984,5078831,8838301,6606689,11477651,0.897359905394,0.837717903731,0.941691959195
2020-04-07,2379,16880,,,,,,,233535,184310,288886,3989303,3180661,4986618,9071836,6790999,11766537,0.896655252641,0.837187696946,0.940835988038
2020-04-08,2182,19062,,,,,,,228442,179733,282855,3925091,3129591,4893087,9300278,6970732,12049392,0.896051900198,0.836754199992,0.940166141698
2020-04-09,2151,21213,,,,,,,223389,175248,277112,3858573,3074550,4800620,9523667,7145980,12326504,0.895524409779,0.83627506894,0.939581285192
2020-04-10,2146,23359,,,,,,,218398,170791,271509,3790089,3015877,4708804,9742065,7316771,12598013,0.895054225075,0.835908608731,0.93911362765
2020-04-11,2124,25483,,,,,,,213486,166509,265609,3720000,2954974,4617217,9955551,7483280,12863622,0.894624398529,0.835426177642,0.938687954352
2020-04-12,1853,27336,,,,,,,208664,162391,259426,3648671,2892804,4525508,10164215,7645671,13123048,0.89423041647,0.835054819305,0.938355124948
2020-04-13,1906,29242,,,,,,,203942,158367,253921,3576434,2829755,4433730,10368157,7804038,13376969,0.893862024326,0.834730133021,0.937941862881
2020-04-14,2457,31699,,,,,,,199324,154488,248517,3503668,2765345,4342827,10567481,7958526,13625486,0.893517195491,0.8342957738,0.937574332132
2020-04-15,2609,34308,,,,,,,194813,150560,243137,3430705,2701051,4253118,10762294,8109086,13868623,0.893194742623,0.833952555422,0.937213649375
2020-04-16,2175,36483,,,,,,,190409,146715,238163,3357853,2636981,4165054,10952703,8255801,14106786,0.892886196335,0.833656923961,0.936860808465
2020-04-17,2666,39149,,,,,,,186110,143009,233252,3285395,2573680,4078524,11138813,8398810,14340038,0.892593920766,0.833383087322,0.936541458082
2020-04-18,2445,41594,,,,,,,181915,139318,228431,3213579,2511190,3993442,11320728,8538128,14568469,0.892314801534,0.833153466524,0.936262261374
2020-04-19,1276,42870,,,,,,,177822,135720,223926,3142627,2449538,3909941,11498550,8673848,14792395,0.892049393361,0.833000079503,0.935992941296
2020-04-20,1834,44704,,,,,,,173828,132128,219428,3072721,2388575,3828231,11672378,8805976,15011823,0.891798278329,0.832848403438,0.93574300403
2020-04-21,2504,47208,,,,,,,169929,128790,215020,3004007,2328549,3748501,11842307,8934766,15226843,0.891560590637,0.832670891368,0.935470149807
2020-04-22,2431,49639,,,,,,,166125,125583,210827,2936596,2269836,3670523,12008432,9060349,15437670,0.891338313115,0.832477189722,0.935214588581
2020-04-23,2466,52105,,,,,,,162412,122294,206689,2870566,2212393,3594427,12170844,9182643,15644359,0.89113435138,0.832295661246,0.934985413355
2020-04-24,2154,54259,,,,,,,158791,119159,202783,2805969,2156280,3520166,12329635,9301802,15847142,0.890952515418,0.832143240618,0.934817456522
2020-04-25,1697,55956,,,,,,,155262,116006,199049,2742833,2101465,3447770,12484897,9417808,16046191,0.890798159506,0.832119498017,0.934559265732
2020-04-26,1330,57286,,,,,,,151822,112995,195398,2681169,2047925,3377616,12636719,9530803,16241589,0.890678860738,0.832113549618,0.934381629225
2020-04-27,1467,58753,,,,,,,148470,110035,191843,2620974,1995542,3310083,12785189,9640838,16433432,0.890604591914,0.832010858024,0.934177075362
2020-04-28,2241,60994,,,,,,,145207,107081,188373,2562239,1944235,3244571,12930396,9747919,16621805,0.890588979308,0.832093566338,0.934021799648
2020-04-29,2521,63515,,,,,,,142031,104228,185061,2504945,1893952,3181139,13072427,9852147,16806866,0.890650292565,0.832225983006,0.933874766396
2020-04-30,2324,65839,,,,,,,138946,101391,181859,2449078,1844766,3119877,13211373,9953538,16988725,0.890812729667,0.832293208532,0.933762292124
2020-05-01,1891,67730,,,,,,,135952,98771,178669,2394621,1796809,3060393,13347325,10052309,17167394,0.891108106869,0.832207710899,0.933718115294
2020-05-02,1692,69422,,,,,,,133050,96182,175580,2341561,1749975,3002726,13480375,10148491,17342974,0.89157766716,0.83210927874,0.933769162465
2020-05-03,1121,70543,,,,,,,130243,93578,172500,2289888,1704232,2946791,13610618,10242069,17515474,0.89227384274,0.832052269962,0.934318903488
2020-05-04,1333,71876,,,,,,,127534,91090,169603,2239601,1659604,2892462,13738152,10333159,17685077,0.893261500727,0.83195203659,0.934713439923
2020-05-05,2318,74194,,,,,,,124930,88735,166845,2190703,1616214,2839870,13863082,10421894,17851922,0.894617850564,0.832060073034,0.935953969757
2020-05-06,2363,76557,,,,,,,122434,86534,164203,2143207,1573957,2789042,13985516,10508428,18016125,0.896429821392,0.832189353526,0.94005443378
2020-05-07,1936,78493,,,,,,,120051,84350,161685,2097134,1532723,2739889,14105567,10592778,18177810,0.898787604501,0.832789661007,0.952271130241
2020-05-08,1747,80240,,,,,,,117792,82241,159229,2052514,1492668,2692419,14223359,10675019,18337039,0.901773773584,0.833511090148,0.968448993158
2020-05-09,1488,81728,,,,,,,115663,80331,156993,2009385,1453835,2646620,14339022,10755350,18494032,0.905449587758,0.834389380421,0.987736910658
2020-05-10,894,82622,,,,,,,113676,78472,154886,1967800,1416298,2602450,14452698,10833822,18648918,0.909843510903,0.83518799183,1.01130363353
2020-05-11,1015,83637,,,,,,,111842,76872,153014,1927820,1380172,2560060,14564540,10910694,18801932,0.914949157598,0.836330451725,1.03018946089
2020-05-12,1626,85263,,,,,,,110175,75389,151365,1889525,1345526,2519577,14674715,10986083,18953297,0.920736752716,0.838418930857,1.05986954088
2020-05-13,1763,87026,,,,,,,108689,74058,149888,1853008,1312504,2481088,14783404,11060141,19103185,0.927173277587,0.841334470094,1.09009802838
2020-05-14,1783,88809,,,,,,,107398,72879,148752,1818375,1281158,2444774,14890802,11133020,19251937,0.934239244217,0.844957387753,1.11650632363
2020-05-15,1681,90490,,,,,,,106319,71924,147713,1785748,1251700,2410621,14997121,11204944,19399650,0.94193330921,0.851757574314,1.13916941534
2020-05-16,1216,91706,,,,,,,105466,71001,147072,1755262,1223947,2379016,15102587,11275945,19546722,0.950266992865,0.861040714881,1.15841001071
2020-05-17,758,92464,,,,,,,104854,70310,146599,1727066,1198094,2350022,15207441,11346255,19693321,0.959257444715,0.873260673882,1.17384842941
2020-05-18,776,93240,,,,,,,104497,69752,146322,1701320,1174295,2323832,15311938,11416007,19839643,0.968920029915,0.874940030193,1.1861249758
2020-05-19,1555,94795,,,,,,,104409,69366,146595,1678195,1152604,2300802,15416347,11485373,19986238,0.979254027093,0.875151203767,1.19826382131
2020-05-20,1579,96374,,,,,,,104605,69262,147133,1657870,1133167,2281063,15520952,11554635,20133371,0.99021828164,0.875585868571,1.20968866328
2020-05-21,1234,97608,,,,,,,105094,69437,147925,1640531,1116108,2264753,15626046,11624072,20281296,1.0017080171,0.876090936243,1.22045809553
2020-05-22,1273,98881,,,,,,,105890,69956,148901,1626369,1101756,2251938,15731936,11694028,20430197,1.01355285958,0.877259794455,1.23504104721
2020-05-23,1130,100011,,,,,,,107004,70722,150492,1615582,1090283,2243167,15838940,11764750,20580689,1.02554663353,0.878174006751,1.24565154355
2020-05-24,614,100625,,,,,,,108448,71629,152333,1608367,1081636,2238475,15947388,11836379,20733022,1.03749756212,0.878514316882,1.25323747633
2020-05-25,523,101148,,,,,,,110233,72810,154537,1604924,1076030,2238098,16057621,11909189,20887559,1.04927171016,0.878897020289,1.26109764022
2020-05-26,695,101843,,,,,,,112378,74330,157205,1605459,1073546,2242259,16169999,11983519,21044764,1.06080627454,0.879805123628,1.26443814043
2020-05-27,1518,103361,,,,,,,114894,76102,160179,1610178,1074309,2251040,16284893,12059621,21204943,1.07209059588,0.880892466,1.27375256366
2020-05-28,1192,104553,,,,,,,117789,78358,163655,1619278,1078648,2264780,16402682,12137979,21368598,1.0831317476,0.8822834261,1.29084365841
2020-05-29,1171,105724,,,,,,,121074,80916,167719,1632954,1086714,2283713,16523756,12218895,21536317,1.09393129177,0.884769192789,1.30101091068
2020-05-30,979,106703,,,,,,,124766,83881,172396,1651402,1098703,2308364,16648522,12302776,21708713,1.10451204949,0.888092840272,1.31028489062
2020-05-31,591,107294,,,,,,,128882,86980,177437,1674818,1114718,2338702,16777404,12389756,21886150,1.11488163249,0.892923321846,1.31175388613
2020-06-01,777,108071,,,,,,,133441,90561,182861,1703405,1134996,2374939,16910845,12480317,22069011,1.12504898572,0.899906929563,1.31183370135
2020-06-02,1043,109114,,,,,,,138459,94583,188944,1737367,1159849,2417539,17049304,12574900,22257955,1.13496810994,0.909281597161,1.31273616776
2020-06-03,1011,110125,,,,,,,143953,99028,195392,1776911,1189527,2466315,17193257,12673928,22453347,1.14454171403,0.922448850509,1.31556608475
2020-06-04,1023,111148,,,,,,,149944,103737,202435,1822250,1224008,2521589,17343201,12777665,22655782,1.15361262947,0.930904656851,1.31951018761
2020-06-05,949,112097,,,,,,,156445,108755,210524,1873601,1263325,2584140,17499646,12886420,22866306,1.16203590555,0.93647850388,1.33025725986
2020-06-06,687,112784,,,,,,,163473,114362,219435,1931184,1307725,2654624,17663119,13000782,23085741,1.16970694503,0.941016091128,1.33875799013
2020-06-07,447,113231,,,,,,,171045,120435,229072,1995225,1357438,2733149,17834164,13121217,23314813,1.17654186129,0.948914967395,1.3460129624
2020-06-08,513,113744,,,,,,,179173,126955,239883,2065950,1412775,2820642,18013337,13248172,23554696,1.18251182464,0.958353677272,1.34703805067
2020-06-09,945,114689,,,,,,,187868,134053,251210,2143585,1474020,2917250,18201205,13382225,23805906,1.1875916599,0.971804647752,1.3490939504
2020-06-10,918,115607,,,,,,,197133,141318,262793,2228340,1541008,3022782,18398338,13523543,24068699,1.19178658315,0.988910010365,1.35006410799
2020-06-11,888,116495,,,,,,,206964,149114,275005,2320410,1614004,3137560,18605302,13672657,24343704,1.19512469196,1.00995509406,1.35176829168
2020-06-12,832,117327,,,,,,,217350,157372,288338,2419971,1693002,3262216,18822652,13830029,24632042,1.19761586126,1.03641436852,1.35350608394
2020-06-13,763,118090,,,,,,,228266,165870,302110,2527163,1777931,3396577,19050918,13995899,24934152,1.19928948007,1.05764573476,1.35565989682
2020-06-14,308,118398,,,,,,,239676,174975,316240,2642072,1868996,3540405,19290594,14170874,25250392,1.20011968935,1.05425557755,1.3546080318
2020-06-15,391,118789,,,,,,,251525,184466,331417,2764716,1966460,3694387,19542119,14355340,25581809,1.20011405361,1.05298803656,1.35620377768
2020-06-16,843,119632,,,,,,,263744,194136,346026,2895019,2070030,3857592,19805863,14549476,25927835,1.19925120409,1.04305816415,1.35599030296
2020-06-17,752,120384,,,,,,,276247,204385,360843,3032807,2179829,4029563,20082110,14753861,26288678,1.197521265,1.03216007404,1.35705794994
2020-06-18,710,121094,,,,,,,288930,214439,374731,3177784,2295230,4209007,20371040,14968300,26663409,1.19492832082,1.01842795428,1.35708448683
2020-06-19,672,121766,,,,,,,301680,224864,389444,3329520,2416335,4396125,20672720,15193164,27052853,1.19146076752,1.01325537271,1.35684344655
2020-06-20,613,122379,,,,,,,314371,235374,403715,3487445,2542925,4589417,20987091,15428538,27456568,1.18713461461,1.00847821631,1.35615970844
2020-06-21,284,122663,,,,,,,326875,246331,417148,3650847,2674851,4787195,21313966,15674869,27873716,1.18195682403,1.00034522371,1.35631254384
2020-06-22,387,123050,,,,,,,339068,257036,430472,3818870,2811420,4988654,21653034,15931905,28304188,1.17601459803,0.992978350389,1.35693557205
2020-06-23,847,123897,,,,,,,350835,267836,443004,3990531,2952284,5191800,22003869,16199741,28747192,1.169414382,0.984774205403,1.35545368614
2020-06-24,764,124661,,,,,,,362075,278879,455171,4164738,3097095,5395735,22365944,16478620,29202363,1.16226736991,0.97682847672,1.35394248833
2020-06-25,559,125220,,,,,,,372703,289309,466635,4340307,3245068,5599524,22738647,16767929,29668998,1.15469169915,0.970748963037,1.35184647412
2020-06-26,612,125832,,,,,,,382652,299552,476746,4515995,3395496,5801183,23121299,17067481,30145744,1.14677250769,0.964539471505,1.34928791243
2020-06-27,500,126332,,,,,,,391873,308853,486089,4690518,3546984,5998836,23513172,17376334,30631833,1.13860697061,0.955438260697,1.35020863972
2020-06-28,251,126583,,,,,,,400336,317179,495141,4862588,3698330,6191786,23913508,17693513,31126974,1.13026823442,0.94989579016,1.34885406635
2020-06-29,364,126947,,,,,,,408029,324831,503197,5030942,3848269,6378669,24321537,18018344,31630171,1.1218270443,0.946941852665,1.34582265542
2020-06-30,735,127682,,,,,,,414956,331393,511050,5194373,3995283,6558269,24736493,18349737,32141221,1.11333700414,0.942175130866,1.34091531451
2020-07-01,687,128369,,,,,,,421135,337320,517160,5351763,4138555,6729392,25157628,18687057,32658381,1.10481482782,0.940350415653,1.3342772106
2020-07-02,724,129093,,,,,,,426590,342685,523313,5502107,4276906,6891861,25584218,19029742,33181694,1.09626754517,0.938812320823,1.32593882381
2020-07-03,653,129746,,,,,,,431354,346729,528320,5644530,4409202,7045432,26015572,19376471,33710014,1.08768112282,0.935112114897,1.31552527916
2020-07-04,271,130017,,,,,,,435456,350097,533008,5778306,4534413,7189005,26451028,19726568,34243022,1.0790670206,0.931356181783,1.31004179834
2020-07-05,299,130316,,,,,,,438931,352998,537592,5902867,4651994,7322903,26889959,20079566,34780614,1.07046747469,0.924562524899,1.30829246411
2020-07-06,351,130667,,,,,,,441813,355099,541540,6017806,4760693,7447305,27331772,20434665,35322154,1.06195780259,0.921908026903,1.3026036398
2020-07-07,1224,131891,,,,,,,444137,356795,544606,6122875,4860376,7561449,27775909,20791460,35866760,1.05363132739,0.919862778661,1.29170656592
2020-07-08,850,132741,,,,,,,445936,358195,547741,6217977,4950653,7666180,28221845,21149655,36414501,1.04558253688,0.916201900128,1.28488925708
2020-07-09,1012,133753,,,,,,,447248,358836,550502,6303150,5030510,7761502,28669093,21508491,36965003,1.03789097454,0.911217413009,1.27565070482
2020-07-10,830,134583,,,,,,,448104,359047,552772,6378552,5100168,7847658,29117197,21867538,37517775,1.0306116126,0.910345288709,1.2678484103
2020-07-11,691,135274,,,,,,,448539,358670,554860,6444439,5159215,7925793,29565736,22226208,38072635,1.02378035304,0.906901419959,1.25510635319
2020-07-12,451,135725,,,,,,,448584,357698,556834,6501149,5208009,7996584,30014320,22583906,38629469,1.01741659472,0.905366226868,1.243633366
2020-07-13,389,136114,,,,,,,448267,356465,557672,6549080,5247267,8059176,30462587,22940371,39187141,1.0115229508,0.904599232355,1.23072532505
2020-07-14,928,137042,,,,,,,447616,355138,558752,6588666,5277567,8114803,30910203,23295509,39745893,1.00608625981,0.90118515076,1.21718875098
2020-07-15,968,138010,,,,,,,446657,353275,558679,6620367,5299452,8162512,31356860,23648784,40304572,1.00108380767,0.900067105863,1.20009422165
2020-07-16,953,138963,,,,,,,445413,350849,559035,6644645,5312988,8204473,31802273,23999633,40863607,0.996492343007,0.899134480456,1.19188794154
2020-07-17,920,139883,,,,,,,443906,348481,559282,6661961,5318789,8240520,32246179,24348114,41422889,0.992293600749,0.898623159369,1.17996396093
2020-07-18,870,140753,,,,,,,442157,345464,559116,6672764,5317517,8271377,32688336,24693578,41982005,0.988473296098,0.898146969825,1.16062102852
2020-07-19,445,141198,,,,,,,440184,342602,559106,6677492,5310010,8297520,33128520,25036180,42541111,0.985016438802,0.895760918965,1.14322748398
2020-07-20,514,141712,,,,,,,438005,339741,557913,6676566,5296743,8317875,33566525,25375921,43099024,0.981903691406,0.89095218842,1.13063647644
2020-07-21,1109,142821,,,,,,,435635,336447,556219,6670387,5278082,8332577,34002160,25712368,43655243,0.979110740923,0.887464878533,1.1106681422
2020-07-22,1211,144032,,,,,,,433087,333093,554938,6659337,5254368,8342921,34435247,26045461,44210181,0.97660964271,0.884223006584,1.08260571535
2020-07-23,1121,145153,,,,,,,430374,329179,554045,6643775,5225328,8349221,34865621,26374640,44764226,0.974370578675,0.883688448646,1.06765043971
2020-07-24,1123,146276,,,,,,,427509,325597,553133,6624036,5192060,8351837,35293130,26700237,45317359,0.972363434389,0.88320001574,1.05726358958
2020-07-25,901,147177,,,,,,,424503,321589,551419,6600435,5154578,8350473,35717633,27021826,45868778,0.970559250054,0.882384688783,1.05054472325
2020-07-26,477,147654,,,,,,,421367,317195,549545,6573262,5113078,8345156,36139000,27339021,46418323,0.968931556966,0.881667033216,1.04486654409
2020-07-27,1125,148779,,,,,,,418110,312818,547042,6542789,5068178,8335381,36557110,27651839,46965365,0.967457381653,0.880884259179,1.04347381868
2020-07-28,1368,150147,,,,,,,414744,308319,544401,6509266,5020015,8322140,36971854,27960158,47509766,0.966117653052,0.880496693096,1.03965510347
2020-07-29,1436,151583,,,,,,,411276,303650,542033,6472925,4968514,8305454,37383130,28263808,48051799,0.964896908754,0.880128944649,1.03456199636
2020-07-30,1216,152799,,,,,,,407715,299321,539811,6433983,4914549,8286613,37790845,28563129,48591610,0.963782445786,0.879777533109,1.03170892738
2020-07-31,1246,154045,,,,,,,404070,294774,537498,6392640,4858463,8265102,38194915,28857903,49129108,0.962763256322,0.879439955024,1.0309694128
2020-08-01,1111,155156,,,,,,,400348,290155,535152,6349083,4800134,8240993,38595263,29148058,49664260,0.961829119925,0.879114395114,1.02980861237
2020-08-02,406,155562,,,,,,,396558,285563,532385,6303484,4740237,8214276,38991821,29433621,50196645,0.960970084658,0.87879952309,1.0291378385
2020-08-03,539,156101,,,,,,,392706,281089,529546,6256006,4678732,8184726,39384527,29714710,50726191,0.960176361331,0.878494350884,1.02744036781
2020-08-04,1378,157479,,,,,,,388800,276462,526353,6206801,4615466,8153167,39773327,29991172,51252544,0.959438500399,0.878198132297,1.02645009928
2020-08-05,1372,158851,,,,,,,384847,271799,523271,6156013,4550828,8120212,40158174,30262971,51775815,0.958747674923,0.877910292412,1.02588863209
2020-08-06,1250,160101,,,,,,,380852,267143,520511,6103779,4484885,8085783,40539026,30530114,52296326,0.958095931938,0.87811912663,1.02504802391
2020-08-07,1243,161344,,,,,,,376823,262656,517212,6050228,4418372,8048957,40915849,30792770,52813538,0.957476343968,0.877607678046,1.02389710285
2020-08-08,1076,162420,,,,,,,372765,258131,514006,5995484,4350907,8009839,41288614,31050901,53327544,0.956883050714,0.877101608424,1.02256678321
2020-08-09,515,162935,,,,,,,368683,253782,510756,5939664,4283093,7969189,41657297,31304683,53838300,0.956311213363,0.876471256657,1.02176370071
2020-08-10,525,163460,,,,,,,364584,249605,507279,5882882,4215489,7926942,42021881,31554288,54345579,0.955756913904,0.875795445998,1.02126149774
2020-08-11,1064,164524,,,,,,,360472,245405,503756,5825244,4148058,7883676,42382353,31799693,54849335,0.955217028695,0.875524177801,1.02073802857
2020-08-12,1507,166031,,,,,,,356352,241312,499594,5766852,4081030,7838891,42738705,32041005,55348929,0.954689097437,0.875154508249,1.01937729566
2020-08-13,1076,167107,,,,,,,352227,237123,495484,5707804,4014483,7792362,43090932,32278128,55844413,0.954171200464,0.874822662876,1.01886567701
2020-08-14,1342,168449,,,,,,,348103,232977,491598,5648192,3948119,7744162,43439035,32511105,56336011,0.953661850754,0.87457992308,1.01841568898
2020-08-15,1029,169478,,,,,,,343981,228906,487449,5588104,3882237,7694115,43783016,32740011,56823460,0.953159902771,0.874343517488,1.01796398067
2020-08-16,571,170049,,,,,,,339866,224691,483079,5527622,3816761,7642036,44122882,32964702,57306539,0.952664477728,0.874113293818,1.01738865495
2020-08-17,445,170494,,,,,,,335761,220400,478738,5466824,3751591,7588379,44458643,33185102,57785277,0.952174903548,0.873889102853,1.01679419348
2020-08-18,1324,171818,,,,,,,331668,216243,474319,5405785,3686738,7533140,44790311,33401345,58259596,0.951690667392,0.873670798382,1.01622735579
2020-08-19,1356,173174,,,,,,,327589,212025,470048,5344573,3622298,7476819,45117900,33613370,58729644,0.951211378507,0.873458237156,1.01565843532
2020-08-20,1078,174252,,,,,,,323526,208153,466134,5283253,3558649,7419666,45441426,33821523,59195778,0.95073673942,0.873251278835,1.01512847186
2020-08-21,1115,175367,,,,,,,319482,204308,462549,5221883,3495814,7361694,45760908,34025831,59658327,0.95026652372,0.873049785957,1.01467105316
2020-08-22,983,176350,,,,,,,315459,200630,458601,5160519,3433789,7303070,46076367,34226461,60116928,0.949800559007,0.8728536239,1.01421213975
2020-08-23,,,990,740,1303,177340,177090,177653,311458,196945,454172,5099212,3372602,7243226,46387825,34423406,60571100,,,
2020-08-24,,,983,730,1299,178322,177820,178952,307792,193423,450656,5038320,3312241,7183118,46695617,34616829,61021756,,,
2020-08-25,,,975,720,1294,179298,178541,180246,304144,189965,446860,4977880,3252599,7122699,46999761,34806794,61468616,,,
2020-08-26,,,968,710,1291,180266,179251,181536,300530,186686,443322,4917938,3193877,7062264,47300291,34993480,61911938,,,
2020-08-27,,,960,700,1287,181226,179952,182823,296967,183399,439554,4858554,3135964,7002219,47597258,35176879,62351492,,,
2020-08-28,,,952,690,1283,182178,180642,184105,293485,180290,435925,4799811,3079129,6942656,47890743,35357169,62787417,,,
2020-08-29,,,944,680,1279,183122,181322,185383,290117,177166,432230,4741826,3023318,6883289,48180860,35534335,63219647,,,
2020-08-30,,,935,670,1273,184058,181993,186656,286840,173961,428924,4684684,2968371,6824766,48467700,35708296,63648571,,,
2020-08-31,,,927,659,1267,184984,182652,187922,283634,171107,425700,4628452,2914784,6767392,48751334,35879403,64074271,,,
2020-09-01,,,918,649,1260,185902,183301,189181,280501,168354,422953,4573192,2862738,6711619,49031835,36047757,64497224,,,
2020-09-02,,,909,638,1253,186811,183940,190434,277442,165667,419895,4518966,2812163,6657207,49309277,36213424,64917119,,,
2020-09-03,,,900,627,1247,187711,184568,191680,274469,162890,417115,4465846,2763030,6604287,49583746,36376314,65334234,,,
2020-09-04,,,891,617,1240,188602,185185,192919,271583,160386,414507,4413903,2715266,6552671,49855329,36536700,65748741,,,
2020-09-05,,,881,607,1232,189484,185793,194151,268779,157738,412708,4363199,2668700,6502842,50124108,36694438,66161449,,,
2020-09-06,,,872,596,1225,190356,186389,195375,266055,155407,411148,4313795,2623479,6455402,50390163,36849845,66572597,,,
2020-09-07,,,863,586,1217,191218,186976,196592,263411,152845,409008,4265748,2579381,6410249,50653574,37002690,66981605,,,
2020-09-08,,,853,577,1209,192071,187554,197800,260851,150349,406882,4218808,2536309,6366485,50914425,37153039,67388487,,,
2020-09-09,,,844,567,1201,192915,188122,199000,258376,148155,405035,4173040,2494501,6324669,51172801,37301194,67793522,,,
2020-09-10,,,834,558,1191,193749,188680,200191,255986,145639,402541,4128496,2453455,6283891,51428787,37446833,68196063,,,
2020-09-11,,,824,549,1182,194573,189229,201372,253682,143283,400417,4085211,2413342,6244749,51682469,37590116,68596480,,,
2020-09-12,,,815,539,1172,195388,189768,202543,251464,141090,399111,4043189,2374145,6207929,51933933,37731206,68995591,,,
2020-09-13,,,805,530,1162,196193,190299,203705,249332,138966,399100,4002404,2335948,6174795,52183265,37870172,69394691,,,
2020-09-14,,,796,520,1152,196989,190819,204857,247289,136651,398778,3962853,2298640,6144639,52430554,38006823,69793469,,,
2020-09-15,,,786,511,1143,197775,191330,205999,245335,134382,398296,3924554,2261916,6117219,52675889,38141205,70191765,,,
2020-09-16,,,777,501,1133,198552,191832,207131,243472,132373,398084,3887526,2225936,6092339,52919361,38273578,70589849,,,
2020-09-17,,,768,491,1123,199320,192324,208253,241698,130086,398327,3851782,2190354,6070762,53161059,38403664,70988176,,,
2020-09-18,,,758,482,1114,200078,192807,209366,240011,128045,398951,3817324,2155505,6052592,53401070,38531709,71387127,,,
2020-09-19,,,749,474,1105,200828,193281,210470,238411,126015,399355,3784153,2121131,6037438,53639481,38657724,71786482,,,
2020-09-20,,,741,466,1096,201568,193747,211565,236896,124293,400096,3752271,2087684,6024825,53876377,38782017,72186578,,,
2020-09-21,,,732,458,1087,202300,194206,212651,235465,122451,400696,3721681,2054730,6014374,54111842,38904468,72587274,,,
2020-09-22,,,723,450,1077,203023,194656,213727,234116,120488,401986,3692386,2022377,6007355,54345958,39024956,72989260,,,
2020-09-23,,,715,442,1069,203738,195099,214795,232845,118542,403102,3664380,1990574,6003578,54578803,39143498,73392362,,,
2020-09-24,,,706,434,1060,204444,195534,215854,231651,116581,404523,3637655,1959005,6003078,54810454,39260079,73796885,,,
2020-09-25,,,698,427,1051,205143,195961,216904,230535,114694,406234,3612204,1928062,6006778,55040989,39374773,74203119,,,
2020-09-26,,,690,420,1043,205833,196382,217946,229496,112904,409263,3588017,1897686,6015623,55270485,39487677,74612382,,,
2020-09-27,,,683,412,1035,206515,196794,218981,228529,111149,412438,3565083,1867745,6028947,55499014,39598826,75024820,,,
2020-09-28,,,675,405,1028,207190,197200,220007,227634,109462,415477,3543384,1838241,6045322,55726648,39708288,75440297,,,
2020-09-29,,,668,398,1021,207858,197599,221027,226807,107660,418207,3522902,1809254,6064739,55953455,39815948,75858504,,,
2020-09-30,,,660,392,1014,208518,197992,222040,226046,105871,420758,3503613,1780748,6087184,56179501,39921819,76279262,,,
2020-10-01,,,653,385,1008,209171,198378,223046,225353,104295,423985,3485494,1752672,6113069,56404854,40026114,76703247,,,
2020-10-02,,,646,379,1003,209818,198758,224048,224725,102708,427470,3468522,1725293,6142192,56629579,40128822,77130717,,,
2020-10-03,,,640,373,998,210458,199132,225044,224162,101196,431349,3452672,1698445,6174571,56853741,40230018,77562066,,,
2020-10-04,,,633,368,993,211091,199500,226035,223660,99633,434912,3437921,1672066,6210110,57077401,40329651,77996978,,,
2020-10-05,,,627,362,988,211718,199863,227022,223217,98228,438373,3424242,1646003,6248373,57300618,40427879,78435351,,,
2020-10-06,,,621,356,983,212339,200220,228003,222832,96840,442029,3411608,1620398,6289693,57523450,40524719,78877380,,,
2020-10-07,,,615,350,977,212954,200570,228979,222504,95559,445559,3399996,1595476,6333256,57745954,40620278,79322939,,,
2020-10-08,,,610,344,972,213564,200916,229949,222233,94023,449041,3389384,1570962,6379187,57968187,40714301,79771980,,,
2020-10-09,,,604,339,968,214168,201255,230915,222015,92569,452540,3379748,1546956,6427206,58190202,40806870,80224520,,,
2020-10-10,,,599,334,966,214767,201591,231879,221848,91181,455903,3371061,1523445,6476880,58412050,40898051,80680423,,,
2020-10-11,,,594,329,967,215361,201921,232844,221732,89947,459509,3363297,1500488,6527130,58633782,40987998,81139932,,,
2020-10-12,,,589,324,965,215950,202245,233807,221663,88709,463436,3356432,1478044,6578127,58855445,41076707,81603368,,,
2020-10-13,,,585,318,963,216535,202564,234768,221641,87482,467570,3350438,1456058,6630213,59077086,41164189,82070938,,,
2020-10-14,,,580,313,963,217115,202878,235729,221663,86272,471427,3345295,1434664,6683425,59298749,41250461,82542365,,,
2020-10-15,,,576,309,965,217691,203188,236691,221729,85056,474755,3340978,1413847,6737413,59520478,41335517,83017120,,,
2020-10-16,,,572,303,965,218263,203492,237655,221838,84038,479160,3337462,1393588,6792576,59742316,41419555,83496280,,,
2020-10-17,,,568,299,966,218831,203792,238618,221985,83117,483563,3334722,1373992,6848651,59964301,41502672,83979843,,,
2020-10-18,,,565,294,967,219395,204087,239583,222170,82239,488191,3332730,1355028,6905470,60186471,41584911,84468034,,,
2020-10-19,,,561,290,968,219956,204378,240549,222391,81282,492653,3331461,1336675,6963189,60408862,41666193,84960687,,,
2020-10-20,,,558,286,970,220514,204665,241517,222645,80242,497354,3330889,1318687,7022142,60631507,41746435,85458041,,,
2020-10-21,,,555,281,972,221069,204948,242486,222930,79366,501790,3330988,1301213,7081874,60854437,41825801,85959831,,,
2020-10-22,,,552,277,975,221621,205225,243458,223247,78312,505741,3331731,1283965,7142025,61077684,41904113,86465572,,,
2020-10-23,,,549,272,980,222171,205499,244435,223591,77382,509363,3333089,1267322,7202307,61301275,41981495,86974935,,,
2020-10-24,,,547,268,985,222717,205768,245417,223961,76511,513549,3335035,1251262,7263283,61525236,42058006,87488484,,,
2020-10-25,,,545,264,991,223262,206033,246405,224355,75696,518133,3337542,1235774,7325477,61749591,42133702,88006617,,,
2020-10-26,,,542,260,997,223804,206294,247399,224772,74863,522486,3340582,1220686,7388425,61974363,42208565,88529103,,,
2020-10-27,,,540,256,1003,224345,206551,248399,225210,74104,526132,3344129,1206080,7451096,62199573,42282669,89055235,,,
2020-10-28,,,539,252,1010,224883,206804,249405,225668,73296,528912,3348156,1191895,7512419,62425241,42355965,89584147,,,
2020-10-29,,,537,248,1018,225420,207053,250419,226142,72597,533463,3352635,1178223,7574440,62651383,42428562,90117610,,,
2020-10-30,,,535,244,1026,225956,207298,251441,226631,71968,536759,3357536,1165137,7636437,62878014,42500530,90654369,,,
2020-10-31,,,534,240,1034,226490,207539,252472,227133,71260,541125,3362832,1152361,7698399,63105147,42571790,91195494,,,
2020-11-01,,,533,237,1043,227023,207777,253511,227646,70556,545224,3368493,1139800,7760065,63332793,42642346,91740718,,,
