date,actual_deaths,total_deaths,predicted_deaths_mean,predicted_deaths_lower,predicted_deaths_upper,predicted_total_deaths_mean,predicted_total_deaths_lower,predicted_total_deaths_upper,predicted_new_infected_mean,predicted_new_infected_lower,predicted_new_infected_upper,predicted_current_infected_mean,predicted_current_infected_lower,predicted_current_infected_upper,predicted_total_infected_mean,predicted_total_infected_lower,predicted_total_infected_upper,r_values_mean
2020-02-05,0,0,,,,,,,98,49,150,98,49,150,98,49,150,2.26884538222
2020-02-06,0,0,,,,,,,98,49,150,195,99,300,196,98,300,2.26719567845
2020-02-07,0,0,,,,,,,98,49,150,293,149,450,294,147,450,2.26692942599
2020-02-08,0,0,,,,,,,98,49,150,391,199,600,392,196,600,2.2666203314
2020-02-09,0,0,,,,,,,238,108,392,628,318,982,630,304,992,2.26626154438
2020-02-10,0,0,,,,,,,238,108,392,866,429,1371,868,412,1384,2.26584513363
2020-02-11,0,0,,,,,,,238,108,392,1104,539,1761,1106,520,1776,2.26536192088
2020-02-12,0,0,,,,,,,238,108,392,1341,648,2152,1344,628,2168,2.26480129092
2020-02-13,0,0,,,,,,,366,172,628,1707,835,2765,1710,800,2796,2.26415097464
2020-02-14,0,0,,,,,,,510,259,830,2216,1098,3591,2220,1059,3626,2.2633823888
2020-02-15,0,0,,,,,,,704,377,1109,2920,1490,4686,2924,1436,4735,2.26250621148
2020-02-16,0,0,,,,,,,729,393,1142,3649,1890,5820,3653,1829,5877,2.26148695356
2020-02-17,0,0,,,,,,,857,469,1305,4506,2369,7115,4510,2298,7182,2.26030694512
2020-02-18,0,0,,,,,,,1159,634,1765,5665,3010,8874,5669,2932,8947,2.25894075409
2020-02-19,0,0,,,,,,,2428,1390,3335,8093,4459,12150,8097,4322,12282,2.25735922784
2020-02-20,0,0,,,,,,,2522,1448,3455,10517,5875,15436,10619,5770,15737,2.25552848298
2020-02-21,0,0,,,,,,,2924,1675,3970,13343,7525,19230,13543,7445,19707,2.25340973654
2020-02-22,0,0,,,,,,,3753,2217,5086,16998,9719,24137,17296,9662,24793,2.25096029741
2020-02-23,0,0,,,,,,,3907,2313,5295,20808,11991,29273,21203,11975,30088,2.24813087746
2020-02-24,0,0,,,,,,,5993,3577,8066,26563,15561,36901,27196,15552,38154,2.24486449326
2020-02-25,0,0,,,,,,,6981,4318,9287,33307,19836,45758,34177,19870,47441,2.2410960927
2020-02-26,0,0,,,,,,,7731,4827,10286,40800,24593,55632,41908,24697,57727,2.23675140825
2020-02-27,0,0,,,,,,,8207,5140,10937,48769,29639,66170,50115,29837,68664,2.23174647816
2020-02-28,0,0,,,,,,,11951,7292,16058,60355,36795,81568,62066,37129,84722,2.2259855573
2020-02-29,1,1,,,,,,,12706,7766,17125,72551,44310,97857,74772,44895,101847,2.21935886854
2020-03-01,0,1,,,,,,,14773,9072,19987,86620,53030,116722,89545,53967,121834,2.21174019102
2020-03-02,5,6,,,,,,,17575,10860,24022,103467,63517,139581,107120,64827,145856,2.20298365581
2020-03-03,1,7,,,,,,,20520,12565,28560,123130,75648,166809,127640,77392,174416,2.19291950925
2020-03-04,4,11,,,,,,,27897,16886,39344,149868,91942,204273,155537,94278,213760,2.18134785388
2020-03-05,1,12,,,,,,,33506,20337,47524,180947,110927,248372,189043,114615,261284,2.16803005962
2020-03-06,2,14,,,,,,,39104,23680,55964,217528,133190,300803,228147,138295,317248,2.15267759545
2020-03-07,3,17,,,,,,,46013,27819,66488,260618,159357,363250,274160,166114,383736,2.13493792867
2020-03-08,4,21,,,,,,,54961,33210,79804,311825,190367,437899,329121,199324,463540,2.11437802683
2020-03-09,1,22,,,,,,,66295,40304,95999,374213,228370,528547,395416,239628,559539,2.09046753388
2020-03-10,6,28,,,,,,,78959,48324,112674,447179,273126,633120,474375,287952,672213,2.06256685131
2020-03-11,8,36,,,,,,,91574,56898,127555,531772,325677,751394,565949,344850,799768,2.02992963676
2020-03-12,4,40,,,,,,,105102,66870,146480,629143,387659,887607,671051,411720,946248,1.991733516
2020-03-13,7,47,,,,,,,119533,76319,168130,740470,458781,1044839,790584,488039,1114378,1.94715466894
2020-03-14,7,54,,,,,,,134158,88206,190296,862677,539697,1219076,924742,576245,1304674,1.89549725238
2020-03-15,9,63,,,,,,,148225,100232,207044,998195,632135,1409035,1072967,676477,1511718,1.83637440266
2020-03-16,22,85,,,,,,,160929,109978,218585,1144352,732996,1607686,1233896,786455,1730303,1.76991506871
2020-03-17,23,108,,,,,,,172365,119729,234136,1299141,841825,1817834,1406261,906184,1964439,1.69694678112
2020-03-18,10,118,,,,,,,182581,128483,246786,1461202,957718,2036077,1588842,1034667,2211225,1.61908811548
2020-03-19,82,200,,,,,,,191637,136873,258549,1624942,1077720,2255241,1780479,1171540,2469774,1.53868636015
2020-03-20,44,244,,,,,,,199526,142699,264165,1790962,1200128,2471809,1980005,1314239,2733939,1.45856678916
2020-03-21,63,307,,,,,,,206209,148892,271888,1958067,1325412,2687649,2186214,1463131,3005827,1.38162354714
2020-03-22,119,426,,,,,,,211802,153622,278068,2123855,1451320,2899158,2398016,1616753,3283895,1.31035816985
2020-03-23,125,551,,,,,,,216490,159543,281367,2285385,1577811,3100654,2614506,1776296,3565262,1.24651387134
2020-03-24,153,704,,,,,,,220393,163266,288080,2439483,1700959,3292694,2834899,1939562,3853342,1.19092149188
2020-03-25,237,941,,,,,,,223578,166581,290231,2584103,1819435,3470167,3058477,2106143,4143573,1.14357687676
2020-03-26,267,1208,,,,,,,226065,169252,293709,2718593,1931964,3636184,3284542,2275395,4437282,1.10387309713
2020-03-27,370,1578,,,,,,,227882,171673,296980,2841372,2036895,3786574,3512424,2447068,4734262,1.07087406328
2020-03-28,445,2023,,,,,,,229075,173533,296851,2950914,2134151,3915223,3741499,2620601,5031113,1.04354304776
2020-03-29,436,2459,,,,,,,229695,174446,296672,3046451,2220419,4021616,3971194,2795047,5327785,1.0208914506
2020-03-30,516,2975,,,,,,,229749,175355,295521,3127976,2295543,4110110,4200943,2970402,5623306,1.00205320815
2020-03-31,895,3870,,,,,,,229272,175956,294006,3196318,2361517,4185531,4430215,3146358,5917312,0.986307256737
2020-04-01,883,4753,,,,,,,228290,176047,291542,3252243,2417818,4242984,4658505,3322405,6208854,0.973070871858
2020-04-02,1169,5922,,,,,,,226843,175706,288884,3296506,2464941,4285154,4885348,3498111,6497738,0.961880365249
2020-04-03,1162,7084,,,,,,,224977,175022,286446,3329845,2502993,4313171,5110325,3673133,6784184,0.952368799774
2020-04-04,1320,8404,,,,,,,222735,174222,282868,3353054,2534397,4331975,5333060,3847355,7067052,0.944245403004
2020-04-05,1212,9616,,,,,,,220159,172989,278674,3367005,2558369,4338860,5553219,4020344,7345726,0.937278392467
2020-04-06,1162,10778,,,,,,,217294,170995,274110,3372496,2575610,4335020,5770513,4191339,7619836,0.931281415392
2020-04-07,1941,12719,,,,,,,214183,168805,269267,3370189,2584787,4323023,5984696,4360144,7889103,0.926103167119
2020-04-08,1973,14692,,,,,,,210874,166977,264335,3360670,2588437,4299440,6195570,4527121,8153438,0.921619568467
2020-04-09,1783,16475,,,,,,,207413,164520,259263,3344505,2586312,4268580,6402983,4691641,8412701,0.917727905071
2020-04-10,2104,18579,,,,,,,203839,161521,253800,3322279,2578487,4228737,6606822,4853162,8666501,0.914342429822
2020-04-11,1875,20454,,,,,,,200186,159442,248323,3294584,2566147,4180143,6807008,5012604,8914824,0.909733646605
2020-04-12,1560,22014,,,,,,,196484,156231,242977,3261993,2548736,4126313,7003492,5168835,9157801,0.90582043229
2020-04-13,1505,23519,,,,,,,192757,153471,237583,3225054,2527678,4067255,7196249,5322306,9395384,0.902757615316
2020-04-14,2321,25840,,,,,,,189025,150513,232714,3184329,2502760,4004460,7385274,5472819,9628098,0.901047873243
2020-04-15,2485,28325,,,,,,,185304,147582,227610,3140362,2474324,3938073,7570578,5620401,9855708,0.89979964691
2020-04-16,4591,32916,,,,,,,181608,145064,222268,3093680,2443310,3868808,7752186,5765465,10077976,0.898691016539
2020-04-17,3857,36773,,,,,,,177951,141956,217340,3044788,2409550,3797280,7930137,5907421,10295316,0.897703775319
2020-04-18,1891,38664,,,,,,,174345,138968,212673,2994156,2373489,3723537,8104482,6046389,10507989,0.896506458891
2020-04-19,1997,40661,,,,,,,170790,136138,208192,2942210,2335403,3648891,8275272,6182527,10716181,0.895182134722
2020-04-20,1433,42094,,,,,,,167296,132975,203906,2889347,2295391,3574141,8442568,6315502,10920087,0.894123060377
2020-04-21,2349,44443,,,,,,,163864,130200,199957,2835917,2254598,3500008,8606432,6445702,11120044,0.893378228808
2020-04-22,2179,46622,,,,,,,160505,127402,195965,2782239,2213192,3426716,8766937,6573104,11316009,0.892998905905
2020-04-23,3327,49949,,,,,,,157219,124599,192009,2728585,2170802,3354395,8924156,6697703,11508018,0.892658461783
2020-04-24,1997,51946,,,,,,,154002,121789,188271,2675174,2128066,3283401,9078158,6819492,11696289,0.8923597865
2020-04-25,1806,53752,,,,,,,150870,118797,184944,2622206,2085337,3214544,9229028,6938289,11881233,0.892109127206
2020-04-26,1126,54878,,,,,,,147818,115891,181730,2569837,2041772,3147950,9376846,7054180,12062963,0.89175318406
2020-04-27,1365,56243,,,,,,,144851,112913,178503,2518205,1998438,3083477,9521697,7167093,12241466,0.891501596496
2020-04-28,2109,58352,,,,,,,141967,110023,175271,2467414,1954972,3021162,9663664,7277116,12416737,0.891430019975
2020-04-29,2612,60964,,,,,,,139165,107172,172527,2417555,1911614,2960976,9802829,7384288,12589264,0.891583048776
2020-04-30,2029,62993,,,,,,,136463,104362,169898,2368714,1868377,2903264,9939292,7488650,12759162,0.891947727852
2020-05-01,2005,64998,,,,,,,133848,101987,167261,2320954,1825285,2848260,10073140,7590637,12926423,0.892573201801
2020-05-02,1368,66366,,,,,,,131309,99341,164234,2274312,1782664,2795162,10204449,7689978,13090657,0.893555649625
2020-05-03,1312,67678,,,,,,,128858,96865,161577,2228826,1740556,2744081,10333307,7786843,13252234,0.895009275183
2020-05-04,1241,68919,,,,,,,126495,94452,159066,2184531,1698867,2694968,10459802,7881295,13411300,0.897051939412
2020-05-05,2142,71061,,,,,,,124209,92012,156872,2141444,1657902,2647944,10584011,7973307,13568172,0.89977446824
2020-05-06,2366,73427,,,,,,,122010,89716,154746,2099590,1617420,2602744,10706021,8063023,13722918,0.903194141989
2020-05-07,2228,75655,,,,,,,119897,87598,152567,2058982,1577621,2559350,10825918,8150621,13875485,0.907207759573
2020-05-08,1522,77177,,,,,,,117868,85511,150696,2019630,1538537,2518039,10943786,8236132,14026181,0.911576151392
2020-05-09,1612,78789,,,,,,,115927,83515,149024,1981555,1500267,2478793,11059713,8319647,14175205,0.914861760743
2020-05-10,734,79523,,,,,,,114074,81580,147318,1944758,1463054,2441168,11173787,8401227,14322523,0.918035130821
2020-05-11,1155,80678,,,,,,,112308,79608,145478,1909248,1426773,2404915,11286095,8480835,14468001,0.920989710795
2020-05-12,1695,82373,,,,,,,110605,77759,143707,1875002,1391623,2370116,11396700,8558594,14611708,0.923667136261
2020-05-13,1743,84116,,,,,,,108989,76042,142097,1842025,1357647,2336935,11505689,8634636,14753805,0.926064911343
2020-05-14,1779,85895,,,,,,,107460,74355,140857,1810319,1324838,2305254,11613149,8708991,14894662,0.928234460887
2020-05-15,1632,87527,,,,,,,106012,72810,139583,1779869,1293294,2274928,11719161,8781801,15034245,0.930274405486
2020-05-16,1224,88751,,,,,,,104636,71313,138406,1750657,1262629,2246058,11823797,8853114,15172651,0.93232297741
2020-05-17,808,89559,,,,,,,103340,69986,137333,1722687,1233279,2219139,11927137,8923100,15309984,0.934550335037
2020-05-18,785,90344,,,,,,,102126,68657,136470,1695955,1205075,2194010,12029263,8991757,15446454,0.937147482474
2020-05-19,1574,91918,,,,,,,100984,67351,135656,1670444,1177977,2170573,12130247,9059108,15582110,0.940304669583
2020-05-20,1518,93436,,,,,,,99923,66101,134942,1646158,1152070,2148615,12230170,9125209,15717052,0.944171640371
2020-05-21,1260,94696,,,,,,,98943,64922,134316,1623092,1127279,2128160,12329113,9190131,15851368,0.948799545324
2020-05-22,1274,95970,,,,,,,98032,63786,133847,1601227,1103469,2109404,12427145,9253917,15985215,0.954082987107
2020-05-23,1107,97077,,,,,,,97187,62717,133558,1580546,1080677,2092229,12524332,9316634,16118773,0.95974144
2020-05-24,640,97717,,,,,,,96422,61687,133243,1561041,1058849,2076415,12620754,9378321,16252016,0.963997546306
2020-05-25,500,98217,,,,,,,95741,60716,133076,1542708,1037986,2062151,12716495,9439037,16385092,0.968066385706
2020-05-26,689,98906,,,,,,,95146,59777,133078,1525546,1018156,2049732,12811641,9498814,16518170,0.971817909532
2020-05-27,1509,100415,,,,,,,94651,58900,133246,1509592,999298,2039254,12906292,9557714,16651416,0.975177363044
2020-05-28,1198,101613,,,,,,,94270,58099,133628,1494872,981356,2030776,13000562,9615813,16785044,0.97813417609
2020-05-29,1193,102806,,,,,,,94013,57375,134138,1481426,964379,2024056,13094575,9673188,16919182,0.980738478849
2020-05-30,967,103773,,,,,,,93885,56727,134991,1469298,948294,2019463,13188460,9729915,17054173,0.983091305087
2020-05-31,605,104378,,,,,,,93886,56193,135909,1458548,933173,2016973,13282346,9786108,17190082,0.985333693195
2020-06-01,768,105146,,,,,,,93991,55675,137163,1449200,918861,2016816,13376337,9841783,17327245,0.987636417507
2020-06-02,1031,106177,,,,,,,94117,55151,138428,1441190,905352,2018790,13470454,9896934,17465673,0.99018779496
2020-06-03,980,107157,,,,,,,94355,54711,139959,1434562,892711,2023117,13564809,9951645,17605632,0.993173115336
2020-06-04,1037,108194,,,,,,,94678,54364,141722,1429317,880973,2029927,13659487,10006009,17747354,0.996738575577
2020-06-05,1162,109356,,,,,,,95084,54082,143484,1425457,870128,2039122,13754571,10060091,17890838,1.00093924644
2020-06-06,709,110065,,,,,,,95537,53798,145440,1422963,860136,2050743,13850108,10113889,18036278,1.00568729341
2020-06-07,442,110507,,,,,,,96018,53506,147517,1421794,850921,2064727,13946126,10167395,18183795,1.01073529137
2020-06-08,501,111008,,,,,,,96547,53189,149606,1421920,842419,2081115,14042673,10220584,18333401,1.0136473735
2020-06-09,978,111986,,,,,,,97122,52940,151810,1423301,834639,2099873,14139795,10273524,18485211,1.01635508271
2020-06-10,935,112921,,,,,,,97739,52739,154238,1425894,827597,2121056,14237534,10326263,18639449,1.01873265158
2020-06-11,896,113817,,,,,,,98361,52527,156696,1429604,821219,2144527,14335895,10378790,18796145,1.02069679653
2020-06-12,848,114665,,,,,,,99012,52270,159093,1434347,815389,2170010,14434907,10431060,18955238,1.02221249471
2020-06-13,768,115433,,,,,,,99692,52028,161660,1440026,810040,2197547,14534599,10483088,19116898,1.02328676948
2020-06-14,,,763,490,1048,116196,115923,116481,100394,51758,164237,1446535,805069,2226807,14634993,10534846,19281135,
2020-06-15,,,754,480,1041,116950,116403,117522,101106,51495,166785,1453755,800371,2257697,14736099,10586341,19447920,
2020-06-16,,,746,471,1036,117696,116874,118557,101819,51214,169445,1461583,795909,2289991,14837918,10637555,19617365,
2020-06-17,,,739,462,1033,118435,117336,119589,102545,50938,172149,1470011,791693,2323724,14940463,10688493,19789514,
2020-06-18,,,733,454,1031,119168,117791,120620,103262,50662,174915,1478918,787643,2358694,15043725,10739155,19964429,
2020-06-19,,,727,446,1030,119895,118238,121649,103987,50412,177663,1488228,783689,2394646,15147712,10789567,20142092,
2020-06-20,,,723,439,1031,120618,118678,122680,104716,50116,180429,1497860,779724,2431601,15252428,10839683,20322521,
2020-06-21,,,719,433,1034,121337,119112,123713,105432,49782,183195,1507755,775708,2469363,15357860,10889465,20505716,
2020-06-22,,,717,428,1038,122054,119540,124750,106128,49413,185913,1517864,771616,2507765,15463988,10938878,20691629,
2020-06-23,,,715,422,1044,122769,119963,125793,106818,49128,188653,1528135,767556,2546815,15570806,10988006,20880282,
2020-06-24,,,714,417,1052,123483,120381,126844,107503,48884,191381,1538516,763501,2586387,15678309,11036890,21071663,
2020-06-25,,,714,413,1060,124197,120795,127903,108168,48534,194232,1548944,759298,2626382,15786477,11085424,21265895,
2020-06-26,,,714,409,1070,124911,121204,128973,108822,48238,197073,1559405,755010,2666757,15895299,11133662,21462968,
2020-06-27,,,715,406,1081,125626,121611,130053,109462,47901,199823,1569855,750642,2707487,16004761,11181563,21662791,
2020-06-28,,,718,403,1096,126344,122015,131147,110088,47573,202602,1580252,746189,2748428,16114849,11229136,21865393,
2020-06-29,,,722,401,1111,127066,122417,132257,110702,47295,205456,1590559,741728,2789646,16225551,11276431,22070849,
2020-06-30,,,726,399,1126,127792,122817,133383,111300,46986,208281,1600753,737220,2831142,16336851,11323417,22279130,
2020-07-01,,,730,397,1143,128522,123214,134525,111884,46665,210970,1610819,732672,2872666,16448735,11370082,22490100,
2020-07-02,,,734,395,1161,129256,123610,135685,112348,46249,213243,1620622,727983,2913760,16561083,11416331,22703343,
2020-07-03,,,739,394,1179,129995,124005,136864,112797,45903,215622,1630156,723223,2954466,16673880,11462234,22918965,
2020-07-04,,,744,392,1198,130739,124397,138061,113223,45539,218078,1639392,718344,2994882,16787103,11507773,23137043,
2020-07-05,,,749,390,1216,131488,124788,139276,113622,45143,220471,1648298,713365,3034924,16900725,11552916,23357514,
2020-07-06,,,754,388,1236,132242,125176,140510,113970,44714,222745,1656836,708290,3074473,17014695,11597630,23580259,
2020-07-07,,,759,386,1255,133001,125563,141765,114259,44255,224953,1664968,703126,3113514,17128954,11641885,23805212,
2020-07-08,,,765,384,1275,133766,125948,143038,114506,43809,227169,1672656,697802,3152029,17243460,11685694,24032381,
2020-07-09,,,770,381,1295,134535,126330,144332,114714,43327,229229,1679867,692240,3189876,17358174,11729021,24261610,
2020-07-10,,,775,379,1315,135311,126710,145646,114882,42865,231192,1686581,686566,3226835,17473056,11771886,24492802,
2020-07-11,,,781,377,1336,136091,127089,146981,115008,42391,232989,1692767,680716,3262750,17588064,11814277,24725791,
2020-07-12,,,786,375,1356,136877,127465,148337,115087,41914,234488,1698392,674727,3297414,17703151,11856191,24960279,
2020-07-13,,,791,372,1377,137669,127839,149713,115120,41416,236137,1703423,668568,3330946,17818271,11897607,25196416,
2020-07-14,,,796,370,1397,138465,128210,151109,115112,40902,237644,1707834,662172,3363131,17933383,11938509,25434060,
2020-07-15,,,802,368,1418,139267,128579,152526,115062,40392,239013,1711596,655575,3393861,18048445,11978901,25673073,
2020-07-16,,,807,366,1439,140073,128946,153964,114963,39841,240575,1714674,648747,3423463,18163408,12018742,25913648,
2020-07-17,,,812,363,1460,140885,129310,155423,114822,39284,241945,1717148,641777,3452160,18278230,12058026,26155593,
2020-07-18,,,817,361,1481,141701,129672,156904,114639,38710,243257,1718990,634580,3479790,18392869,12096736,26398850,
2020-07-19,,,821,358,1502,142523,130032,158404,114415,38150,244224,1720182,627186,3505930,18507284,12134886,26643074,
2020-07-20,,,826,356,1522,143348,130390,159926,114150,37619,245187,1720710,619659,3530643,18621434,12172505,26888261,
2020-07-21,,,830,354,1543,144179,130745,161468,113845,37031,245896,1720584,611970,3553790,18735279,12209536,27134157,
2020-07-22,,,834,351,1563,145013,131098,163031,113502,36510,246668,1719826,604222,3575500,18848781,12246046,27380825,
2020-07-23,,,838,349,1582,145852,131448,164613,113120,35949,247293,1718440,596360,3595620,18961901,12281995,27628118,
2020-07-24,,,842,346,1600,146694,131796,166212,112702,35351,247904,1716428,588380,3614291,19074603,12317346,27876022,
2020-07-25,,,846,343,1618,147539,132141,167829,112248,34780,248355,1713794,580291,3631448,19186851,12352126,28124377,
2020-07-26,,,849,340,1637,148388,132483,169465,111761,34255,248654,1710547,572152,3647108,19298612,12386381,28373031,
2020-07-27,,,851,337,1654,149239,132822,171118,111242,33723,248967,1706702,563958,3661583,19409854,12420104,28621998,
2020-07-28,,,854,334,1671,150093,133158,172788,110690,33182,249074,1702272,555722,3674517,19520544,12453286,28871072,
2020-07-29,,,856,331,1687,150949,133491,174474,110108,32675,249178,1697268,547494,3686049,19630652,12485961,29120250,
2020-07-30,,,858,327,1704,151807,133820,176178,109496,32133,249014,1691702,539234,3696049,19740148,12518094,29369264,
2020-07-31,,,859,324,1719,152667,134146,177896,108857,31621,249014,1685596,531014,3704486,19849005,12549715,29618278,
2020-08-01,,,861,320,1734,153528,134468,179629,108193,31106,248611,1678967,522837,3711150,19957198,12580821,29866889,
2020-08-02,,,862,317,1747,154389,134786,181375,107507,30580,248338,1671835,514707,3716228,20064705,12611401,30115227,
2020-08-03,,,862,313,1758,155251,135102,183131,106798,30078,248201,1664218,506634,3720202,20171503,12641479,30363428,
2020-08-04,,,862,310,1770,156114,135413,184901,106067,29578,247685,1656135,498595,3722697,20277570,12671057,30611113,
2020-08-05,,,862,306,1781,156976,135721,186680,105315,29090,247181,1647605,490654,3723977,20382885,12700147,30858294,
2020-08-06,,,862,302,1792,157837,136024,188472,104546,28613,246847,1638649,482758,3724153,20487431,12728760,31105141,
2020-08-07,,,861,298,1803,158698,136324,190274,103762,28119,246157,1629291,474928,3723016,20591193,12756879,31351298,
2020-08-08,,,860,294,1814,159558,136619,192087,102961,27659,245427,1619551,467237,3720539,20694154,12784538,31596725,
2020-08-09,,,859,289,1823,160417,136911,193908,102146,27204,244685,1609448,459660,3716869,20796300,12811742,31841410,
2020-08-10,,,857,286,1831,161274,137198,195737,101318,26744,243805,1599005,452148,3712020,20897618,12838486,32085215,
2020-08-11,,,855,281,1836,162129,137481,197572,100478,26254,242295,1588242,444678,3705350,20998096,12864740,32327510,
2020-08-12,,,853,277,1843,162981,137759,199413,99630,25809,241050,1577182,437304,3697328,21097726,12890549,32568560,
2020-08-13,,,850,273,1848,163831,138034,201260,98773,25371,240178,1565847,430000,3688329,21196499,12915920,32808738,
2020-08-14,,,847,269,1853,164678,138305,203111,97906,24953,239106,1554257,422820,3678423,21294405,12940873,33047844,
2020-08-15,,,844,264,1858,165522,138571,204967,97033,24533,237847,1542433,415731,3667257,21391438,12965406,33285691,
2020-08-16,,,840,260,1861,166362,138832,206826,96152,24118,236906,1530392,408743,3655554,21487590,12989524,33522597,
2020-08-17,,,837,256,1863,167199,139090,208687,95264,23719,235526,1518149,401882,3642743,21582854,13013243,33758123,
2020-08-18,,,833,252,1865,168032,139344,210550,94371,23321,233911,1505722,395125,3628454,21677225,13036564,33992034,
2020-08-19,,,829,248,1866,168861,139594,212414,93475,22924,232340,1493131,388471,3613109,21770700,13059488,34224374,
2020-08-20,,,824,244,1866,169685,139840,214278,92575,22554,230913,1480391,381936,3596842,21863275,13082042,34455287,
2020-08-21,,,820,240,1865,170505,140082,216141,91673,22209,229471,1467518,375531,3579469,21954948,13104251,34684758,
2020-08-22,,,815,236,1866,171320,140321,218004,90769,21845,227833,1454525,369257,3561149,22045717,13126096,34912591,
2020-08-23,,,810,232,1862,172130,140555,219864,89864,21502,226177,1441427,363099,3541905,22135581,13147598,35138768,
2020-08-24,,,805,228,1860,172935,140785,221722,88959,21152,224005,1428240,357047,3521234,22224540,13168750,35362773,
2020-08-25,,,800,225,1859,173735,141012,223578,88055,20820,222826,1414977,351122,3500260,22312595,13189570,35585599,
2020-08-26,,,794,221,1855,174529,141235,225431,87151,20481,221039,1401650,345350,3479008,22399746,13210051,35806638,
2020-08-27,,,789,217,1851,175318,141455,227279,86249,20164,219208,1388269,339705,3457170,22485995,13230215,36025846,
2020-08-28,,,783,214,1849,176101,141670,229125,85347,19855,217514,1374843,334188,3434509,22571342,13250070,36243360,
2020-08-29,,,777,210,1843,176878,141883,230966,84449,19537,215550,1361386,328771,3410956,22655791,13269607,36458910,
2020-08-30,,,771,207,1838,177649,142091,232801,83553,19241,213543,1347906,323478,3386654,22739344,13288848,36672453,
2020-08-31,,,765,203,1832,178414,142297,234630,82660,18955,211495,1334415,318315,3361244,22822004,13307803,36883948,
2020-09-01,,,759,200,1826,179172,142499,236453,81772,18676,209474,1320923,313271,3335189,22903776,13326479,37093422,
2020-09-02,,,752,196,1814,179925,142697,238264,80887,18397,207520,1307438,308347,3308797,22984663,13344876,37300942,
2020-09-03,,,746,193,1805,180671,142892,240066,80006,18129,205482,1293970,303551,3281937,23064669,13363005,37506424,
2020-09-04,,,740,190,1799,181411,143083,241861,79130,17855,203333,1280524,298852,3254357,23143799,13380860,37709757,
2020-09-05,,,733,186,1789,182144,143272,243647,78259,17594,201429,1267110,294236,3226314,23222058,13398454,37911186,
2020-09-06,,,727,183,1782,182870,143457,245426,77392,17338,199215,1253734,289729,3197697,23299450,13415792,38110401,
2020-09-07,,,720,180,1774,183590,143640,247196,76531,17085,197451,1240402,285311,3168973,23375981,13432877,38307852,
2020-09-08,,,713,177,1764,184304,143819,248956,75676,16837,195218,1227118,280995,3140192,23451657,13449714,38503070,
2020-09-09,,,707,174,1751,185010,143995,250704,74826,16597,193014,1213889,276771,3110385,23526483,13466311,38696084,
2020-09-10,,,700,171,1739,185710,144169,252440,73982,16360,191229,1200720,272649,3080579,23600465,13482671,38887313,
2020-09-11,,,693,168,1729,186404,144340,254165,73144,16127,189080,1187616,268612,3050453,23673609,13498798,39076393,
2020-09-12,,,687,166,1718,187090,144508,255880,72313,15902,187019,1174582,264659,3019960,23745922,13514700,39263412,
2020-09-13,,,680,163,1706,187770,144673,257581,71489,15683,184828,1161622,260804,2989239,23817411,13530383,39448240,
2020-09-14,,,673,161,1694,188443,144836,259271,70671,15465,182819,1148740,257028,2958516,23888082,13545848,39631059,
2020-09-15,,,666,158,1677,189109,144996,260945,69860,15244,180929,1135939,253316,2927950,23957942,13561092,39811988,
2020-09-16,,,659,155,1669,189769,145154,262610,69055,15036,178872,1123222,249676,2897349,24026997,13576128,39990860,
2020-09-17,,,653,153,1655,190421,145309,264261,68257,14830,176850,1110591,246109,2866678,24095254,13590958,40167710,
2020-09-18,,,646,151,1641,191067,145462,265898,67466,14632,174693,1098051,242611,2835890,24162720,13605590,40342403,
2020-09-19,,,639,148,1629,191707,145613,267523,66683,14435,172733,1085604,239191,2805292,24229403,13620025,40515136,
2020-09-20,,,632,146,1614,192339,145761,269133,65907,14244,170565,1073252,235840,2774431,24295310,13634269,40685701,
2020-09-21,,,626,144,1599,192965,145907,270728,65138,14055,168381,1060998,232556,2743600,24360448,13648324,40854082,
2020-09-22,,,619,142,1584,193584,146051,272308,64376,13864,166000,1048843,229335,2712151,24424824,13662188,41020082,
2020-09-23,,,612,139,1569,194196,146193,273873,63621,13677,164503,1036788,226175,2681436,24488445,13675865,41184585,
2020-09-24,,,606,137,1554,194802,146332,275423,62874,13497,162388,1024836,223075,2650813,24551319,13689362,41346973,
2020-09-25,,,599,135,1539,195401,146470,276958,62134,13305,160220,1012988,220020,2619806,24613453,13702667,41507193,
2020-09-26,,,593,133,1523,195994,146606,278476,61401,13128,158380,1001245,217020,2589107,24674854,13715795,41665573,
2020-09-27,,,586,131,1509,196580,146739,279981,60676,12958,156276,989608,214075,2558367,24735530,13728753,41821849,
2020-09-28,,,580,129,1492,197160,146871,281469,59958,12785,154220,978077,211177,2527760,24795488,13741538,41976069,
2020-09-29,,,573,128,1479,197733,147001,282943,59247,12621,152179,966653,208333,2497121,24854735,13754159,42128248,
2020-09-30,,,567,126,1462,198300,147129,284401,58544,12455,150135,955337,205543,2466328,24913279,13766614,42278383,
2020-10-01,,,560,124,1446,198860,147256,285843,57848,12296,148116,944130,202803,2435574,24971127,13778910,42426499,
