date,actual_deaths,total_deaths,predicted_deaths_mean,predicted_deaths_lower,predicted_deaths_upper,predicted_total_deaths_mean,predicted_total_deaths_lower,predicted_total_deaths_upper,predicted_new_infected_mean,predicted_new_infected_lower,predicted_new_infected_upper,predicted_current_infected_mean,predicted_current_infected_lower,predicted_current_infected_upper,predicted_total_infected_mean,predicted_total_infected_lower,predicted_total_infected_upper,r_values_mean
2020-02-05,0,0,,,,,,,114,50,150,114,50,150,114,50,150,2.30507267101
2020-02-06,0,0,,,,,,,114,50,150,228,99,300,228,100,300,2.3048868566
2020-02-07,0,0,,,,,,,114,50,150,342,150,450,342,150,450,2.30484569578
2020-02-08,0,0,,,,,,,114,50,150,456,199,600,456,200,600,2.30479541151
2020-02-09,0,0,,,,,,,273,114,386,728,332,968,729,314,986,2.30473397873
2020-02-10,0,0,,,,,,,273,114,386,1001,452,1348,1002,428,1372,2.30465892154
2020-02-11,0,0,,,,,,,273,114,386,1274,570,1730,1275,542,1758,2.3045672121
2020-02-12,0,0,,,,,,,273,114,386,1546,687,2113,1548,656,2144,2.30445514659
2020-02-13,0,0,,,,,,,444,190,610,1990,899,2701,1992,846,2754,2.30431819282
2020-02-14,0,0,,,,,,,631,298,867,2621,1204,3561,2623,1144,3621,2.30413227651
2020-02-15,0,0,,,,,,,872,450,1165,3493,1694,4723,3495,1594,4786,2.30392534065
2020-02-16,0,0,,,,,,,1535,833,1969,5028,2631,6687,5030,2427,6755,2.30366751318
2020-02-17,0,0,,,,,,,2551,1531,3215,7579,4303,9899,7581,3958,9970,2.3033539409
2020-02-18,0,0,,,,,,,2940,1783,3809,10518,6125,13704,10521,5741,13779,2.30297147166
2020-02-19,0,0,,,,,,,3482,2221,4477,14000,8394,18172,14003,7962,18256,2.30250408676
2020-02-20,0,0,,,,,,,3610,2310,4664,17496,10665,22690,17613,10272,22920,2.30193153279
2020-02-21,0,0,,,,,,,4080,2669,5296,21462,13329,27837,21693,12941,28216,2.30122901198
2020-02-22,0,0,,,,,,,5078,3354,6584,26426,16675,34245,26771,16295,34800,2.30036833367
2020-02-23,0,0,,,,,,,6043,4057,7808,32355,20768,41885,32814,20352,42608,2.29931382778
2020-02-24,0,0,,,,,,,7351,4943,9506,39434,25672,50960,40165,25295,52114,2.29802017475
2020-02-25,0,0,,,,,,,10862,7054,13814,50023,32731,64272,51027,32349,65928,2.29643085889
2020-02-26,0,0,,,,,,,13332,8698,16966,63082,41344,80715,64359,41047,82894,2.29447505887
2020-02-27,0,0,,,,,,,14503,9389,18584,77312,50625,98841,78862,50436,101478,2.2920647651
2020-02-28,0,0,,,,,,,17394,11153,22381,94262,61582,120500,96256,61589,123859,2.28908867915
2020-02-29,1,1,,,,,,,20782,12916,26991,114413,74202,146501,117038,74505,150850,2.28540458545
2020-03-01,0,1,,,,,,,26696,16153,34866,140237,89951,180015,143734,90658,185716,2.280829716
2020-03-02,5,6,,,,,,,33128,19856,43649,171830,109066,221529,176862,110514,229365,2.27512757675
2020-03-03,1,7,,,,,,,40729,24213,54065,210008,131834,272195,217591,134727,283430,2.26799008511
2020-03-04,4,11,,,,,,,49557,29016,66556,256625,159166,334780,267148,163743,349986,2.25901267641
2020-03-05,1,12,,,,,,,61433,35769,83483,314577,192827,413620,328581,199512,433469,2.2476612193
2020-03-06,2,14,,,,,,,74863,43032,103103,385830,233666,511884,403444,242544,536572,2.23323061544
2020-03-07,3,17,,,,,,,90456,51555,125664,472206,282628,632066,493900,294099,662236,2.21479748065
2020-03-08,4,21,,,,,,,108224,61705,150971,575352,341019,776351,602124,355804,813207,2.19117651005
2020-03-09,1,22,,,,,,,128242,73937,179307,697551,410881,947819,730366,429741,992514,2.16090295799
2020-03-10,6,28,,,,,,,150662,88549,208785,840862,494395,1147135,881028,518290,1201299,2.12228239324
2020-03-11,5,33,,,,,,,173325,104370,236724,1003325,591745,1370026,1054353,622660,1438023,2.07356340104
2020-03-12,10,43,,,,,,,195477,122171,261971,1185471,705115,1615042,1249830,744831,1699994,2.01327516672
2020-03-13,9,52,,,,,,,216515,141871,289715,1387482,837466,1886112,1466345,886702,1989709,1.94070215122
2020-03-14,6,58,,,,,,,235359,154951,316015,1605447,981149,2179611,1701704,1041653,2305724,1.85635269938
2020-03-15,12,70,,,,,,,251956,167323,339449,1836621,1135522,2491911,1953660,1208976,2645173,1.76220498909
2020-03-16,27,97,,,,,,,265682,178834,360757,2075607,1298243,2817613,2219342,1387810,3005930,1.66158072298
2020-03-17,34,131,,,,,,,276603,187892,374971,2319083,1466306,3148702,2495945,1575702,3380901,1.55867431601
2020-03-18,57,188,,,,,,,285048,196251,378850,2563401,1638420,3473249,2780993,1771953,3759751,1.45790840759
2020-03-19,76,264,,,,,,,291326,203945,387021,2805171,1813548,3793478,3072319,1975898,4146772,1.36330730816
2020-03-20,97,361,,,,,,,295867,209829,389157,3039604,1987955,4098917,3368186,2185727,4535929,1.27801156936
2020-03-21,94,455,,,,,,,298856,215411,393956,3263598,2160816,4389568,3667042,2401138,4929885,1.20398352171
2020-03-22,145,600,,,,,,,300519,220346,396717,3473661,2330209,4660526,3967561,2621484,5326602,1.14192505062
2020-03-23,183,783,,,,,,,301129,225556,392371,3666567,2494686,4901744,4268690,2847040,5718973,1.09141706524
2020-03-24,237,1020,,,,,,,300868,229205,388282,3839192,2650512,5110412,4569558,3076245,6107255,1.05124136378
2020-03-25,312,1332,,,,,,,299889,231434,384387,3988420,2793936,5285660,4869447,3307679,6491642,1.01977589514
2020-03-26,413,1745,,,,,,,298287,232070,379000,4113382,2922297,5427642,5167734,3539749,6870642,0.99533747763
2020-03-27,552,2297,,,,,,,296122,231994,374459,4214027,3032866,5539850,5463856,3771743,7245101,0.976401034662
2020-03-28,634,2931,,,,,,,293457,232699,371075,4290970,3124446,5621013,5757313,4004442,7616176,0.961695599498
2020-03-29,627,3558,,,,,,,290374,232423,365611,4345985,3202570,5670609,6047687,4236865,7981787,0.950215810467
2020-03-30,820,4378,,,,,,,286849,231399,358587,4380878,3267214,5689761,6334536,4468264,8340374,0.941190710497
2020-03-31,1224,5602,,,,,,,282963,230262,352108,4398160,3318910,5681260,6617499,4698526,8692482,0.934038745197
2020-04-01,1241,6843,,,,,,,278757,228320,343110,4400314,3359221,5649593,6896256,4926846,9035592,0.928324059476
2020-04-02,1586,8429,,,,,,,274277,224433,334097,4389543,3386969,5604792,7170533,5151279,9369689,0.923719933401
2020-04-03,1315,9744,,,,,,,269563,221491,329367,4367780,3404028,5547402,7440096,5372770,9699056,0.919980374918
2020-04-04,1284,11028,,,,,,,264653,217237,323749,4336566,3410674,5482387,7704749,5590007,10022805,0.916918900643
2020-04-05,1439,12467,,,,,,,259587,212350,317257,4297296,3406739,5406253,7964336,5802357,10340062,0.914392999745
2020-04-06,1668,14135,,,,,,,254406,207910,310699,4251183,3393392,5321084,8218742,6010267,10650761,0.912292851491
2020-04-07,2309,16444,,,,,,,249150,203525,302747,4199203,3370345,5231940,8467892,6213792,10953508,0.910533136348
2020-04-08,2116,18560,,,,,,,243859,198856,296366,4142195,3338977,5140329,8711751,6412648,11249874,0.909047066178
2020-04-09,2075,20635,,,,,,,238567,194134,290692,4080872,3300896,5046925,8950318,6606782,11540566,0.907781999656
2020-04-10,2093,22728,,,,,,,233301,189600,283939,4015886,3257953,4952064,9183619,6796382,11824505,0.906696192556
2020-04-11,2046,24774,,,,,,,228085,185087,278314,3947849,3210839,4856190,9411704,6981469,12102819,0.905756365447
2020-04-12,1774,26548,,,,,,,222936,180548,272519,3877328,3158629,4757937,9634640,7162017,12375338,0.904935864919
2020-04-13,1828,28376,,,,,,,217867,176089,266604,3804821,3102347,4659265,9852507,7338106,12641942,0.904213259778
2020-04-14,2404,30780,,,,,,,212885,171642,261343,3730856,3042636,4562178,10065392,7509748,12903285,0.903446883026
2020-04-15,2549,33329,,,,,,,207998,167279,256120,3655891,2979687,4466250,10273390,7677027,13159405,0.902732258488
2020-04-16,2113,35442,,,,,,,203206,162924,250809,3580339,2914247,4373926,10476596,7839951,13410214,0.902112110358
2020-04-17,2614,38056,,,,,,,198515,158746,245788,3504577,2848481,4285547,10675111,7998697,13656002,0.901613658438
2020-04-18,2386,40442,,,,,,,193926,154751,240872,3428939,2781566,4196961,10869037,8153448,13896874,0.901266776706
2020-04-19,1229,41671,,,,,,,189439,150672,236095,3353725,2714832,4109181,11058476,8304120,14132969,0.90094161127
2020-04-20,1795,43466,,,,,,,185054,146682,231409,3279193,2649011,4023196,11243530,8450802,14364378,0.900636763997
2020-04-21,2457,45923,,,,,,,180769,142709,226625,3205556,2583693,3939001,11424299,8593511,14591003,0.900351650988
2020-04-22,2389,48312,,,,,,,176587,138896,222021,3132993,2519007,3858276,11600886,8732407,14813024,0.900058884185
2020-04-23,2434,50746,,,,,,,172505,135251,217148,3061639,2455375,3779121,11773391,8867658,15030172,0.899794424366
2020-04-24,2118,52864,,,,,,,168519,131664,212402,2991591,2392898,3700895,11941910,8999322,15242574,0.899562399413
2020-04-25,1650,54514,,,,,,,164631,128025,207982,2922921,2331324,3625101,12106541,9127347,15450556,0.899366451943
2020-04-26,1293,55807,,,,,,,160842,124584,204127,2855678,2270833,3551089,12267383,9251931,15654683,0.899216899243
2020-04-27,1425,57232,,,,,,,157158,121225,200485,2789900,2211526,3479185,12424541,9373156,15855168,0.899103585337
2020-04-28,2219,59451,,,,,,,153577,117768,196730,2725610,2153222,3409419,12578118,9490924,16051898,0.899036240181
2020-04-29,2506,61957,,,,,,,150090,114473,193292,2662815,2096076,3341439,12728208,9605397,16245190,0.899025401685
2020-04-30,2296,64253,,,,,,,146703,111147,189656,2601520,2039969,3275026,12874911,9716544,16434846,0.899092385512
2020-05-01,1869,66122,,,,,,,143416,108004,186246,2541731,1985058,3210491,13018327,9824548,16621092,0.899258297117
2020-05-02,1556,67678,,,,,,,140228,104959,182978,2483444,1931257,3147699,13158555,9929507,16804070,0.899551832343
2020-05-03,1096,68774,,,,,,,137147,102080,180022,2426665,1878563,3086848,13295702,10031587,16984092,0.900011381546
2020-05-04,1309,70083,,,,,,,134176,99337,177119,2371402,1827205,3027868,13429878,10130924,17161211,0.900686074929
2020-05-05,2307,72390,,,,,,,131316,96655,174327,2317664,1777154,2970782,13561194,10227579,17335538,0.901639113978
2020-05-06,2458,74848,,,,,,,128573,94057,171607,2265469,1728482,2915771,13689767,10321636,17507145,0.902950117938
2020-05-07,1919,76767,,,,,,,125954,91515,168749,2214836,1681089,2862512,13815721,10413151,17675894,0.904717285535
2020-05-08,1727,78494,,,,,,,123474,89142,166080,2165804,1634975,2811461,13939195,10502293,17841974,0.907058099417
2020-05-09,1479,79973,,,,,,,121133,87023,163667,2118418,1590330,2762741,14060328,10589316,18005641,0.910106951191
2020-05-10,879,80852,,,,,,,118946,85018,161353,2072734,1547318,2716125,14179274,10674334,18166994,0.914007330713
2020-05-11,1013,81865,,,,,,,116928,83151,159202,2028819,1505881,2671209,14296202,10757485,18326196,0.918895776794
2020-05-12,1615,83480,,,,,,,115093,81461,157322,1986754,1466117,2628050,14411295,10838946,18483518,0.924875478033
2020-05-13,1751,85231,,,,,,,113456,79943,155639,1946632,1428296,2586965,14524751,10918889,18639157,0.931980536985
2020-05-14,1774,87005,,,,,,,112031,78603,154238,1908574,1392435,2547919,14636782,10997492,18793395,0.940138332119
2020-05-15,1661,88666,,,,,,,110834,77521,153050,1872705,1358820,2511322,14747616,11075013,18946445,0.949145421536
2020-05-16,1223,89889,,,,,,,109872,76611,152107,1839161,1327437,2477185,14857488,11151624,19098552,0.958675830612
2020-05-17,752,90641,,,,,,,109153,75895,151337,1808086,1298381,2445541,14966641,11227519,19249889,0.968331552283
2020-05-18,770,91411,,,,,,,108682,75458,150845,1779620,1271768,2416359,15075323,11302977,19400734,0.977723844731
2020-05-19,1551,92962,,,,,,,108461,75282,150611,1753906,1247722,2389843,15183784,11378259,19551345,0.986554776396
2020-05-20,1568,94530,,,,,,,108496,75285,150597,1731086,1226361,2366102,15292280,11453544,19701942,0.994668473882
2020-05-21,1223,95753,,,,,,,108789,75502,150899,1711302,1207822,2345382,15401069,11529046,19852841,1.00206043705
2020-05-22,1269,97022,,,,,,,109349,76087,151443,1694697,1192417,2328064,15510418,11605133,20004284,1.00885422551
2020-05-23,1121,98143,,,,,,,110185,76930,152254,1681408,1180230,2314226,15620603,11682063,20156538,1.01526334477
2020-05-24,608,98751,,,,,,,111307,77964,153247,1671583,1171200,2303796,15731910,11760027,20309785,1.02155209008
2020-05-25,513,99264,,,,,,,112731,79319,154507,1665367,1165532,2296940,15844641,11839346,20464292,1.02800038937
2020-05-26,685,99949,,,,,,,114474,80934,156178,1662914,1163344,2293901,15959115,11920280,20620470,1.03487088012
2020-05-27,1509,101458,,,,,,,116551,82884,158014,1664372,1164791,2294581,16075666,12003164,20778484,1.0423740947
2020-05-28,1182,102640,,,,,,,118977,85071,160486,1669893,1169945,2299410,16194643,12088235,20938970,1.05063007903
2020-05-29,1166,103806,,,,,,,121762,87629,163191,1679624,1178995,2308343,16316405,12175864,21102161,1.05963151578
2020-05-30,969,104775,,,,,,,124924,90434,166399,1693715,1191928,2321673,16441329,12266298,21268560,1.06922188918
2020-05-31,586,105361,,,,,,,128482,93706,170513,1712325,1209042,2340062,16569811,12360004,21439073,1.07910601036
2020-06-01,772,106133,,,,,,,132446,97181,175034,1735618,1230344,2363737,16702257,12457185,21614107,1.08890173256
2020-06-02,1033,107166,,,,,,,136833,101031,180157,1763770,1255928,2393012,16839090,12558216,21794264,1.09822127445
2020-06-03,990,108156,,,,,,,141662,105239,185830,1796970,1285895,2428186,16980752,12663455,21980094,1.10673380566
2020-06-04,1009,109165,,,,,,,146946,109690,192174,1835421,1320311,2469702,17127698,12773145,22172268,1.11422597711
2020-06-05,970,110135,,,,,,,152697,114578,199215,1879329,1359405,2517947,17280395,12887723,22371483,1.12068288512
2020-06-06,680,110815,,,,,,,158938,119738,206652,1928918,1403077,2573073,17439333,13007461,22578135,1.12614746712
2020-06-07,451,111266,,,,,,,165683,125361,214629,1984415,1451525,2635359,17605016,13132822,22792764,1.13071851917
2020-06-08,505,111771,,,,,,,172944,131230,223542,2046052,1504809,2705540,17777960,13264052,23016306,1.1345933227
2020-06-09,940,112711,,,,,,,180729,137515,232985,2114050,1563015,2783889,17958689,13401567,23249291,1.13793676895
2020-06-10,917,113628,,,,,,,189044,144125,243393,2188620,1626204,2870955,18147733,13545692,23492684,1.14089720752
2020-06-11,881,114509,,,,,,,197883,151225,254587,2269951,1694542,2967392,18345616,13696917,23747271,1.14354555896
2020-06-12,822,115331,,,,,,,207233,158441,266177,2358208,1767915,3072964,18552849,13855358,24013448,1.14597902519
2020-06-13,750,116081,,,,,,,217063,166013,278451,2453509,1846295,3188115,18769912,14021371,24291899,1.14819317985
2020-06-14,298,116379,,,,,,,227326,173812,290852,2555910,1929673,3312496,18997238,14195183,24582751,1.15011870999
2020-06-15,391,116770,,,,,,,237955,182184,304167,2665383,2018142,3446106,19235193,14377367,24886918,1.1516338023
2020-06-16,839,117609,,,,,,,248863,190486,317794,2781800,2111435,3588851,19484056,14567853,25204712,1.15259453882
2020-06-17,751,118360,,,,,,,259949,198891,331515,2904915,2209288,3740219,19744005,14766744,25536227,1.15287751396
2020-06-18,704,119064,,,,,,,271101,207041,345460,3034354,2311085,3899878,20015106,14973785,25881687,1.15238734946
2020-06-19,672,119736,,,,,,,282215,215861,359560,3169623,2417263,4067297,20297321,15189646,26241247,1.15113750131
2020-06-20,610,120346,,,,,,,293201,224490,373101,3310127,2527193,4241213,20590522,15414136,26614348,1.14923597337
2020-06-21,255,120601,,,,,,,303988,232968,387117,3455177,2640445,4421700,20894510,15647104,27001465,1.1467770047
2020-06-22,406,121007,,,,,,,314527,240412,400917,3604022,2755518,4607994,21209037,15887516,27402382,1.14386474772
2020-06-23,837,121844,,,,,,,324778,247063,415564,3755856,2871352,4800003,21533815,16134579,27817946,1.14062464692
2020-06-24,757,122601,,,,,,,334700,252844,430837,3909827,2986666,4997831,21868515,16387423,28248783,1.13712425955
2020-06-25,2422,125023,,,,,,,344252,258322,445768,4065035,3100844,5200194,22212767,16645745,28694551,1.13339287806
2020-06-26,605,125628,,,,,,,353385,262819,461007,4220537,3212422,5406591,22566152,16908564,29155558,1.12944122351
2020-06-27,489,126117,,,,,,,362045,266645,476231,4375349,3320629,5616618,22928197,17175209,29631789,1.12530232974
2020-06-28,241,126358,,,,,,,370181,270401,492338,4528467,3425022,5830478,23298378,17445610,30124127,1.12095602873
2020-06-29,350,126708,,,,,,,377748,272786,507475,4678888,3524004,6047063,23676126,17718396,30631602,1.11636080757
2020-06-30,721,127429,,,,,,,384713,274688,522407,4825647,3616512,6265265,24060839,17993084,31154009,1.11146399783
2020-07-01,673,128102,,,,,,,391060,276394,535413,4967844,3702428,6482859,24451899,18269478,31689422,1.1062205998
2020-07-02,698,128800,,,,,,,396791,278190,548314,5104687,3781747,6699639,24848690,18547668,32237736,1.10061604337
2020-07-03,639,129439,,,,,,,401921,279337,560322,5235507,3854051,6914507,25250611,18827005,32798058,1.09467168249
2020-07-04,247,129686,,,,,,,406474,279866,571273,5359766,3918046,7126236,25657085,19106871,33369331,1.08847514931
2020-07-05,271,129957,,,,,,,410482,280285,581505,5477047,3973810,7334661,26067567,19387156,33950836,1.08215306756
2020-07-06,325,130282,,,,,,,413977,280542,592018,5587036,4021328,7539566,26481544,19667698,34542854,1.07581866585
2020-07-07,1195,131477,,,,,,,416989,280388,601882,5689498,4061222,7740478,26898533,19948086,35144736,1.06957523715
2020-07-08,820,132297,,,,,,,419543,279370,610678,5784264,4093463,7935492,27318076,20227456,35755414,1.06349442961
2020-07-09,990,133287,,,,,,,421666,278292,618607,5871229,4118840,8123074,27739742,20505748,36374021,1.05760875612
2020-07-10,811,134098,,,,,,,423375,277417,626213,5950352,4137869,8303229,28163117,20783165,37000234,1.05192339585
2020-07-11,676,134774,,,,,,,424688,276274,633307,6021654,4151281,8475217,28587805,21059439,37633541,1.0464380712
2020-07-12,428,135202,,,,,,,425617,274629,640150,6085226,4159234,8638822,29013422,21334068,38273691,1.04115102772
2020-07-13,361,135563,,,,,,,426178,272910,645639,6141223,4161716,8791827,29439600,21606978,38919330,1.03604134449
2020-07-14,900,136463,,,,,,,426385,271133,650113,6189861,4160035,8934257,29865985,21878111,39569443,1.03107643775
2020-07-15,949,137412,,,,,,,426253,269252,653613,6231401,4154574,9065404,30292238,22147363,40223056,1.02621744883
2020-07-16,943,138355,,,,,,,425799,267490,655217,6266139,4145650,9185253,30718037,22414853,40878273,1.02142992341
2020-07-17,908,139263,,,,,,,425041,265624,656144,6294389,4133075,9293219,31143078,22680477,41534417,1.01669603391
2020-07-18,853,140116,,,,,,,423995,263416,655902,6316463,4117145,9388980,31567073,22943893,42190319,1.01202312799
2020-07-19,415,140531,,,,,,,422680,260854,656125,6332668,4098126,9474073,31989753,23204747,42846444,1.00744420095
2020-07-20,491,141022,,,,,,,421116,258128,656173,6343302,4075962,9549012,32410869,23462875,43502617,1.00300912311
2020-07-21,1096,142118,,,,,,,419319,255607,655671,6348643,4051027,9612958,32830188,23718482,44158288,0.998770171873
2020-07-22,1195,143313,,,,,,,417307,252896,654282,6348962,4023531,9665602,33247495,23971378,44812570,0.994768650319
2020-07-23,1114,144427,,,,,,,415097,250025,652382,6344515,3994183,9707495,33662592,24221403,45464952,0.991028226939
2020-07-24,1130,145557,,,,,,,412701,247143,650345,6335550,3963035,9739352,34075293,24468546,46115297,0.987555875022
2020-07-25,905,146462,,,,,,,410133,244387,647771,6322308,3930007,9760986,34485426,24712933,46763068,0.984346964833
2020-07-26,470,146932,,,,,,,407407,241864,645194,6305028,3895598,9772912,34892833,24954797,47408262,0.981390197509
2020-07-27,,,892,634,1222,147824,147566,148154,404535,239270,643278,6283946,3860236,9776073,35297368,25194067,48051540,
2020-07-28,,,904,637,1247,148727,148203,149400,401530,236269,640090,6259298,3823581,9770523,35698898,25430336,48691630,
2020-07-29,,,915,639,1272,149642,148842,150671,398402,233421,637018,6231315,3785857,9757413,36097300,25663757,49328648,
2020-07-30,,,925,641,1297,150567,149484,151968,395160,230560,633489,6200222,3747155,9737287,36492460,25894317,49962137,
2020-07-31,,,935,643,1322,151502,150127,153289,391813,227805,630278,6166236,3707456,9712329,36884273,26122122,50592415,
2020-08-01,,,944,644,1346,152446,150771,154635,388369,224889,626751,6129564,3666709,9682934,37272642,26347011,51219166,
2020-08-02,,,952,644,1370,153398,151416,156005,384834,221787,622028,6090403,3625071,9649055,37657476,26568798,51841194,
2020-08-03,,,959,644,1392,154357,152061,157395,381216,218525,616096,6048939,3582732,9609009,38038692,26787323,52457290,
2020-08-04,,,966,643,1413,155323,152704,158807,377526,215565,610794,6005349,3540161,9563637,38416218,27002888,53068084,
2020-08-05,,,971,641,1431,156294,153346,160238,373770,212663,605648,5959800,3497214,9513658,38789988,27215551,53673732,
2020-08-06,,,976,639,1449,157270,153985,161685,369958,209484,600382,5912451,3453800,9459835,39159946,27425035,54274114,
2020-08-07,,,980,637,1464,158250,154623,163148,366099,206275,594389,5863454,3410049,9401949,39526045,27631310,54868503,
2020-08-08,,,983,634,1479,159234,155257,164627,362202,203091,589047,5812955,3366004,9340769,39888247,27834401,55457550,
2020-08-09,,,986,631,1492,160220,155888,166118,358273,200012,583092,5761094,3321635,9276205,40246520,28034413,56040642,
2020-08-10,,,988,627,1504,161207,156516,167620,354319,196928,576714,5708006,3276704,9207834,40600839,28231341,56617356,
2020-08-11,,,989,624,1514,162196,157141,169133,350348,193867,570968,5653819,3231308,9135633,40951187,28425208,57188324,
2020-08-12,,,989,620,1520,163184,157761,170651,346365,190970,564660,5598654,3186008,9060299,41297552,28616178,57752984,
2020-08-13,,,988,616,1525,164173,158377,172175,342375,188139,558490,5542628,3140720,8981849,41639927,28804317,58311474,
2020-08-14,,,987,612,1530,165160,158989,173704,338383,185354,551934,5485850,3095509,8900372,41978310,28989671,58863408,
2020-08-15,,,985,607,1535,166145,159597,175237,334392,182449,546072,5428429,3050146,8816232,42312702,29172120,59409480,
2020-08-16,,,983,601,1537,167128,160199,176773,330406,179744,539493,5370467,3004994,8729036,42643108,29351864,59948973,
2020-08-17,,,980,595,1539,168108,160795,178311,326429,177146,532668,5312062,2960345,8639720,42969537,29529010,60481641,
2020-08-18,,,977,590,1540,169085,161385,179849,322462,174476,526173,5253308,2916286,8549827,43291999,29703486,61007814,
2020-08-19,,,973,584,1540,170058,161970,181388,318509,171925,520217,5194291,2872637,8459270,43610508,29875411,61528031,
2020-08-20,,,968,578,1539,171026,162548,182925,314571,169079,514543,5135091,2829046,8368168,43925079,30044490,62042574,
2020-08-21,,,963,572,1537,171989,163121,184460,310650,166534,508982,5075783,2786091,8276763,44235729,30211024,62551556,
2020-08-22,,,958,565,1535,172947,163687,185993,306748,163582,502856,5016432,2743395,8185216,44542477,30374606,63054412,
2020-08-23,,,952,560,1532,173899,164247,187523,302868,160883,496241,4957098,2701189,8092406,44845345,30535489,63550653,
2020-08-24,,,946,554,1526,174844,164802,189047,299310,158316,490595,4898135,2659497,7999902,45144655,30693805,64041248,
2020-08-25,,,939,547,1520,175783,165349,190564,295768,155720,485097,4839584,2618296,7908285,45440423,30849525,64526345,
2020-08-26,,,932,540,1513,176716,165890,192075,292259,153120,479525,4781494,2577558,7816836,45732682,31002645,65005870,
2020-08-27,,,925,534,1507,177641,166425,193579,288796,150619,474572,4723925,2537214,7726751,46021478,31153264,65480442,
2020-08-28,,,917,528,1500,178558,166954,195076,285411,148226,469267,4666961,2497306,7637537,46306889,31301490,65949709,
2020-08-29,,,910,521,1491,179468,167476,196565,282133,146043,464301,4610712,2457998,7549918,46589022,31447533,66414010,
2020-08-30,,,902,514,1479,180370,167991,198042,278940,143908,459541,4555259,2419459,7463403,46867962,31591441,66873551,
2020-08-31,,,893,507,1466,181263,168499,199505,275812,141804,454809,4500665,2381521,7378749,47143774,31733245,67328360,
2020-09-01,,,885,500,1454,182148,169000,200956,272750,139794,449846,4446987,2344169,7295956,47416524,31873039,67778206,
2020-09-02,,,876,494,1443,183025,169495,202396,269756,137783,445047,4394280,2307474,7214865,47686280,32010822,68223253,
2020-09-03,,,868,487,1431,183892,169982,203825,266839,135762,441097,4342611,2271306,7135785,47953119,32146584,68664350,
2020-09-04,,,859,479,1418,184751,170463,205240,263999,133706,437374,4292039,2235930,7058651,48217118,32280290,69101724,
2020-09-05,,,850,472,1405,185601,170936,206642,261231,131875,434216,4242620,2201264,6983912,48478349,32412165,69535940,
2020-09-06,,,841,465,1392,186442,171402,208031,258533,129960,430447,4194405,2167633,6911517,48736882,32542125,69966387,
2020-09-07,,,832,458,1378,187274,171861,209406,255903,128348,427003,4147440,2135091,6842289,48992785,32670473,70393390,
2020-09-08,,,822,451,1365,188096,172313,210767,253344,126518,423522,4101474,2103291,6775235,49246129,32796991,70816912,
2020-09-09,,,813,444,1351,188909,172758,212115,250856,124759,420709,4056562,2072330,6710877,49496985,32921750,71237621,
2020-09-10,,,804,438,1335,189713,173197,213447,248439,123040,417798,4012743,2042252,6649179,49745424,33044790,71655419,
2020-09-11,,,795,431,1321,190507,173629,214765,246091,121313,414903,3970037,2012948,6589528,49991515,33166103,72070322,
2020-09-12,,,785,425,1306,191293,174055,216068,243811,119609,412098,3928436,1984331,6532377,50235326,33285712,72482420,
2020-09-13,,,776,418,1291,192069,174474,217356,241600,118032,409922,3887903,1956320,6478010,50476926,33403744,72892342,
2020-09-14,,,767,412,1275,192835,174888,218628,239458,116549,407932,3848421,1928961,6426403,50716384,33520293,73300274,
2020-09-15,,,758,406,1260,193593,175295,219885,237384,115063,406048,3809993,1902221,6377645,50953768,33635356,73706322,
2020-09-16,,,749,401,1247,194342,175697,221128,235379,113710,404989,3772622,1876136,6332794,51189147,33749066,74111311,
2020-09-17,,,740,394,1234,195081,176092,222359,233442,112122,402799,3736308,1850474,6290555,51422589,33861188,74514110,
2020-09-18,,,731,388,1220,195812,176481,223575,231573,110724,400547,3701042,1825436,6250030,51654162,33971912,74914657,
2020-09-19,,,722,382,1206,196534,176864,224778,229771,109227,398597,3666814,1800956,6211282,51883933,34081139,75313254,
2020-09-20,,,714,376,1191,197248,177242,225966,228037,107821,397881,3633620,1776901,6174961,52111970,34188960,75711135,
2020-09-21,,,705,370,1177,197953,177613,227139,226372,106613,396973,3601459,1753555,6141498,52338342,34295573,76108108,
2020-09-22,,,697,364,1165,198650,177978,228300,224774,105346,396431,3570329,1730550,6110924,52563116,34400919,76504539,
2020-09-23,,,689,358,1152,199338,178337,229449,223243,103966,395598,3540229,1708000,6083001,52786359,34504885,76900137,
2020-09-24,,,681,353,1140,200019,178691,230585,221781,102778,395521,3511154,1686022,6057812,53008140,34607663,77295658,
2020-09-25,,,673,347,1127,200692,179039,231708,220387,101633,396019,3483102,1664618,6036030,53228527,34709296,77691677,
2020-09-26,,,665,342,1115,201357,179383,232819,219061,100507,396529,3456072,1643817,6017648,53447588,34809803,78088206,
2020-09-27,,,658,337,1104,202014,179721,233919,217803,99346,396717,3430064,1623556,6002252,53665391,34909149,78484923,
2020-09-28,,,650,332,1094,202665,180054,235009,216612,98233,397928,3405076,1603760,5990239,53882003,35007382,78882851,
2020-09-29,,,643,327,1083,203308,180383,236087,215486,96983,398977,3381104,1584199,5981258,54097489,35104365,79281828,
2020-09-30,,,636,323,1071,203944,180707,237155,214426,95843,400505,3358147,1564982,5975682,54311915,35200208,79682333,
2020-10-01,,,629,318,1062,204573,181026,238213,213431,94708,401842,3336199,1545980,5972495,54525346,35294916,80084175,
2020-10-02,,,623,313,1054,205196,181340,239263,212500,93664,403786,3315257,1527520,5973443,54737846,35388580,80487961,
2020-10-03,,,616,309,1044,205812,181650,240302,211628,92619,405864,3295312,1509415,5978745,54949474,35481199,80893825,
2020-10-04,,,610,305,1035,206422,181957,241334,210816,91506,407806,3276357,1491695,5987966,55160290,35572705,81301631,
2020-10-05,,,604,300,1027,207026,182259,242356,210064,90388,409510,3258384,1474264,5999591,55370354,35663093,81711141,
2020-10-06,,,598,296,1018,207624,182556,243370,209371,89529,411828,3241383,1457182,6014459,55579725,35752622,82122969,
2020-10-07,,,592,292,1012,208215,182849,244377,208732,88632,413787,3225342,1440468,6031819,55788457,35841254,82536756,
2020-10-08,,,586,288,1004,208802,183139,245377,208147,87548,415810,3210245,1424048,6052039,55996604,35928802,82952566,
2020-10-09,,,581,284,997,209383,183424,246370,207615,86649,418202,3196079,1407916,6074725,56204219,36015451,83370768,
2020-10-10,,,576,280,991,209958,183706,247356,207137,85789,421024,3182829,1392071,6099738,56411356,36101240,83791792,
2020-10-11,,,570,277,987,210529,183984,248339,206709,84810,423734,3170477,1376375,6126957,56618065,36186050,84215526,
2020-10-12,,,565,273,982,211094,184259,249316,206331,83850,426407,3159006,1360882,6156659,56824396,36269900,84641933,
2020-10-13,,,561,270,979,211655,184530,250290,206000,83138,428869,3148394,1345790,6187616,57030396,36353038,85070802,
2020-10-14,,,556,266,974,212211,184798,251259,205714,82274,431547,3138622,1331086,6220205,57236110,36435312,85502349,
2020-10-15,,,552,263,968,212762,185062,252223,205473,81390,434394,3129668,1316636,6254114,57441583,36516702,85936743,
2020-10-16,,,547,259,964,213310,185323,253183,205275,80553,437242,3121512,1302483,6289527,57646858,36597255,86373985,
2020-10-17,,,543,256,962,213853,185581,254140,205118,79661,440422,3114130,1288478,6326172,57851976,36676916,86814407,
2020-10-18,,,539,253,960,214392,185835,255095,205001,78713,443581,3107503,1274569,6363905,58056977,36755629,87257988,
2020-10-19,,,535,250,957,214927,186087,256048,204922,77958,447011,3101609,1261017,6403124,58261899,36833587,87704999,
2020-10-20,,,532,247,955,215459,186336,256998,204882,77206,450308,3096427,1247831,6443936,58466781,36910793,88155307,
2020-10-21,,,528,244,954,215987,186582,257948,204880,76454,453323,3091935,1234750,6485444,58671661,36987247,88608630,
2020-10-22,,,525,241,956,216512,186825,258898,204912,75807,456473,3088115,1221918,6528140,58876573,37063054,89065103,
2020-10-23,,,522,239,956,217034,187065,259849,204977,75252,460268,3084946,1209615,6572598,59081550,37138306,89525371,
2020-10-24,,,519,236,956,217552,187303,260800,205075,74468,463546,3082405,1197427,6617937,59286625,37212774,89988917,
2020-10-25,,,516,233,958,218068,187538,261753,205203,73915,467528,3080472,1185545,6664432,59491828,37286689,90456445,
2020-10-26,,,513,230,961,218581,187770,262708,205362,73305,471410,3079124,1174035,6712097,59697190,37359994,90927855,
2020-10-27,,,511,228,963,219092,187999,263666,205549,72703,474951,3078342,1162884,6760630,59902739,37432697,91402806,
2020-10-28,,,508,225,966,219600,188226,264626,205765,72092,478261,3078107,1151836,6810008,60108504,37504789,91881067,
2020-10-29,,,506,222,971,220106,188450,265591,206007,71484,481953,3078400,1141044,6860392,60314511,37576273,92363020,
2020-10-30,,,504,220,976,220610,188672,266561,206272,70858,486113,3079200,1130512,6912090,60520783,37647131,92849133,
2020-10-31,,,502,217,980,221112,188892,267535,206562,70328,489540,3080486,1120288,6964367,60727345,37717459,93338673,
2020-11-01,,,500,215,983,221612,189108,268512,206873,69790,492694,3082241,1110417,7016615,60934218,37787249,93831367,
